Date,User,Kind,Model,Input (w/ Cache Write),Input (w/o Cache Write),Cache Read,Output,Total Tokens,Cost ($)
"2025-08-01T07:40:44.915Z","You","Included in Pro","auto",0,6271,0,446,6717,"Included"
"2025-07-31T10:38:15.562Z","You","Included in Pro","auto",12104,0,44808,4799,61711,"Included"
"2025-07-31T10:08:14.257Z","You","Included in Pro","auto",111192,0,942812,20827,1074831,"Included"
"2025-07-31T10:05:35.822Z","You","Included in Pro","auto",0,53684,0,20344,74028,"Included"
"2025-07-31T10:02:19.313Z","You","Errored, Not Charged","auto",0,0,0,0,0,"Included"
"2025-07-31T09:53:29.930Z","You","Included in Pro","auto",0,150790,0,221,151011,"Included"
"2025-07-31T09:52:54.305Z","You","Included in Pro","auto",0,14812,71552,641,87005,"Included"
"2025-07-31T09:32:34.440Z","You","Included in Pro","auto",0,14492,13952,344,28788,"Included"
"2025-07-31T09:31:56.973Z","You","Errored, Not Charged","auto",0,0,0,0,0,"Included"
"2025-07-31T09:30:23.770Z","You","Errored, Not Charged","auto",0,0,0,0,0,"Included"
"2025-07-31T09:11:40.263Z","You","Included in Pro","auto",0,0,0,0,0,"Included"
"2025-07-31T08:43:17.189Z","You","Included in Pro","auto",35364,64264,76071,30125,205824,"Included"
"2025-07-31T08:35:01.054Z","You","Included in Pro","auto",43528,0,389427,17800,450755,"Included"
"2025-07-31T08:24:53.502Z","You","Included in Pro","auto",4334,0,62023,2992,69349,"Included"
"2025-07-31T08:04:21.247Z","You","Included in Pro","auto",94324,0,734389,23811,852524,"Included"
"2025-07-31T06:52:28.926Z","You","Included in Pro","auto",8828,0,112249,1105,122182,"Included"
"2025-07-29T15:25:17.459Z","You","Included in Pro","auto",46096,0,282637,4498,333231,"Included"
"2025-07-29T15:15:16.394Z","You","Included in Pro","auto",36408,0,297619,6568,340595,"Included"
"2025-07-29T15:05:34.409Z","You","Included in Pro","auto",22101,0,69591,8318,100010,"Included"
"2025-07-29T10:44:54.407Z","You","Included in Pro","auto",26765,0,34266,418,61449,"Included"
"2025-07-29T10:11:46.208Z","You","Included in Pro","auto",14922,0,3842,9663,28427,"Included"
"2025-07-29T10:03:51.013Z","You","Included in Pro","auto",14074,0,88110,5860,108044,"Included"
"2025-07-29T09:51:20.667Z","You","Included in Pro","auto",75642,0,286721,7041,369404,"Included"
"2025-07-29T09:43:45.081Z","You","Included in Pro","auto",54148,0,243732,6928,304808,"Included"
"2025-07-29T09:37:54.834Z","You","Included in Pro","auto",14030,0,11984,4422,30436,"Included"
"2025-07-29T09:33:32.274Z","You","Included in Pro","auto",12260,0,205110,6212,223582,"Included"
"2025-07-29T09:30:41.534Z","You","Included in Pro","auto",3869,0,88403,2169,94441,"Included"
"2025-07-29T09:28:41.619Z","You","Included in Pro","auto",16887,0,7714,4418,29019,"Included"
"2025-07-29T09:27:32.583Z","You","Included in Pro","auto",17209,0,126170,6120,149499,"Included"
"2025-07-29T09:17:34.105Z","You","Included in Pro","auto",540,0,39694,199,40433,"Included"
"2025-07-29T09:15:17.632Z","You","Included in Pro","auto",3590,0,190977,1259,195826,"Included"
"2025-07-29T09:10:49.892Z","You","Included in Pro","auto",32276,0,199422,10465,242163,"Included"
"2025-07-29T08:58:46.359Z","You","Included in Pro","auto",56674,0,462682,13016,532372,"Included"
"2025-07-29T08:51:27.623Z","You","Included in Pro","auto",30937,0,222213,11843,264993,"Included"
"2025-07-29T08:42:32.675Z","You","Included in Pro","auto",18845,0,24635,10088,53568,"Included"
"2025-07-29T07:42:57.453Z","You","Included in Pro","auto",2968,0,425825,1368,430161,"Included"
"2025-07-29T07:40:44.836Z","You","Included in Pro","auto",2711,0,339608,1418,343737,"Included"
"2025-07-29T07:37:05.813Z","You","Included in Pro","auto",14126,0,432244,6489,452859,"Included"
"2025-07-29T07:29:10.944Z","You","Included in Pro","auto",48701,0,959227,10651,1018579,"Included"
"2025-07-29T06:16:44.309Z","You","Included in Pro","auto",52028,0,410225,17422,479675,"Included"
"2025-07-25T09:06:35.639Z","You","Included in Pro","auto",0,57,28672,514,29243,"Included"
"2025-07-25T09:05:18.988Z","You","Included in Pro","auto",0,371,28032,283,28686,"Included"
"2025-07-25T09:04:39.095Z","You","Included in Pro","auto",0,193,27904,58,28155,"Included"
"2025-07-25T09:03:56.435Z","You","Included in Pro","auto",0,22813,4992,215,28020,"Included"
"2025-07-25T08:41:30.406Z","You","Included in Pro","auto",0,15132,26624,6139,47895,"Included"
"2025-07-25T08:33:50.322Z","You","Included in Pro","auto",0,54252,256128,10565,320945,"Included"
"2025-07-25T07:25:02.588Z","You","Included in Pro","auto",0,8592,116992,2537,128121,"Included"
"2025-07-25T07:18:38.726Z","You","Included in Pro","auto",0,13230,85120,4201,102551,"Included"
"2025-07-25T07:12:54.175Z","You","Included in Pro","auto",0,27035,37120,6862,71017,"Included"
"2025-07-25T07:08:50.155Z","You","Included in Pro","auto",0,9878,19968,4802,34648,"Included"
"2025-07-24T18:32:09.956Z","You","Included in Pro","auto",0,29759,29056,739,59554,"Included"
"2025-07-24T18:31:37.628Z","You","Included in Pro","auto",0,22193,34944,720,57857,"Included"
"2025-07-24T18:30:53.828Z","You","Included in Pro","auto",0,945,54016,669,55630,"Included"
"2025-07-24T18:28:10.666Z","You","Included in Pro","auto",0,17348,27904,3031,48283,"Included"
"2025-07-24T18:25:38.408Z","You","Included in Pro","auto",0,47336,117248,3118,167702,"Included"
"2025-07-24T18:23:53.686Z","You","Included in Pro","auto",0,17367,103168,2954,123489,"Included"
"2025-07-24T18:16:08.959Z","You","Included in Pro","auto",0,12267,87936,11724,111927,"Included"
"2025-07-24T18:07:28.814Z","You","Included in Pro","auto",0,37590,37504,6021,81115,"Included"
"2025-07-24T17:55:17.854Z","You","Included in Pro","auto",0,11097,29312,3890,44299,"Included"
"2025-07-24T17:24:04.854Z","You","Included in Pro","auto",0,13035,65152,3952,82139,"Included"
"2025-07-24T08:23:54.096Z","You","Included in Pro","auto",0,12052,37376,6747,56175,"Included"
"2025-07-24T08:20:23.223Z","You","Included in Pro","auto",0,7922,57856,2282,68060,"Included"
"2025-07-24T08:16:38.755Z","You","Included in Pro","auto",0,25349,34688,5366,65403,"Included"
"2025-07-24T07:52:57.766Z","You","Included in Pro","auto",0,2697,20608,2430,25735,"Included"
"2025-07-24T07:52:24.563Z","You","Included in Pro","auto",0,8928,0,357,9285,"Included"
"2025-07-24T05:47:54.129Z","You","Included in Pro","auto",0,12723,84352,6162,103237,"Included"
"2025-07-24T05:46:45.250Z","You","Errored, Not Charged","auto",0,0,0,0,0,"Included"
"2025-07-24T05:45:34.043Z","You","Errored, Not Charged","auto",0,0,0,0,0,"Included"
"2025-07-24T05:37:49.203Z","You","Included in Pro","auto",0,168,24448,125,24741,"Included"
"2025-07-24T05:36:00.620Z","You","Included in Pro","auto",0,17542,18304,6053,41899,"Included"
"2025-07-24T05:29:43.725Z","You","Included in Pro","auto",0,8299,64384,3786,76469,"Included"
"2025-07-24T05:22:29.973Z","You","Included in Pro","auto",0,49859,195200,6345,251404,"Included"
"2025-07-24T05:09:15.317Z","You","Included in Pro","auto",0,10618,19584,4473,34675,"Included"
"2025-07-23T21:22:48.266Z","You","Included in Pro","auto",0,3179,28160,1808,33147,"Included"
"2025-07-23T21:18:37.975Z","You","Included in Pro","auto",0,2029,78848,450,81327,"Included"
"2025-07-23T21:16:55.528Z","You","Included in Pro","auto",0,4231,14080,1600,19911,"Included"
"2025-07-23T21:16:27.040Z","You","Included in Pro","auto",0,7816,15616,1880,25312,"Included"
"2025-07-23T21:10:38.359Z","You","Included in Pro","auto",0,11616,25728,4718,42062,"Included"
"2025-07-23T21:07:24.636Z","You","Included in Pro","auto",0,24441,30976,5144,60561,"Included"
"2025-07-23T21:03:59.770Z","You","Included in Pro","auto",0,25287,6016,5039,36342,"Included"
"2025-07-23T20:56:46.611Z","You","Included in Pro","auto",0,9290,22016,5075,36381,"Included"
"2025-07-23T20:51:54.842Z","You","Included in Pro","auto",0,9237,11264,2173,22674,"Included"
"2025-07-23T20:44:55.898Z","You","Included in Pro","auto",0,14973,99072,845,114890,"Included"
"2025-07-23T20:44:14.395Z","You","Included in Pro","auto",0,1289,6272,853,8414,"Included"
"2025-07-23T20:43:54.930Z","You","Errored, Not Charged","auto",0,0,0,0,0,"Included"
"2025-07-23T20:35:30.753Z","You","Included in Pro","auto",0,16090,104832,1250,122172,"Included"
"2025-07-23T08:27:41.049Z","You","Included in Pro","auto",0,13315,26112,1609,41036,"Included"
"2025-07-23T08:20:43.286Z","You","Included in Pro","auto",0,21578,62464,7634,91676,"Included"
"2025-07-23T08:18:16.173Z","You","Included in Pro","auto",0,35440,735104,5231,775775,"Included"
"2025-07-23T08:15:59.779Z","You","Included in Pro","auto",0,44959,59648,8013,112620,"Included"
"2025-07-23T08:14:43.877Z","You","Included in Pro","auto",0,1059,135680,1349,138088,"Included"
"2025-07-23T08:12:50.141Z","You","Included in Pro","auto",0,7281,120192,6736,134209,"Included"
"2025-07-23T08:10:05.579Z","You","Included in Pro","auto",0,7757,153216,856,161829,"Included"
"2025-07-23T08:09:37.951Z","You","Included in Pro","auto",0,7090,92288,145,99523,"Included"
"2025-07-23T08:07:56.961Z","You","Included in Pro","auto",0,57612,27776,6885,92273,"Included"
"2025-07-23T08:05:21.162Z","You","Included in Pro","auto",0,37048,16640,5887,59575,"Included"
"2025-07-23T08:03:18.873Z","You","Included in Pro","auto",0,6221,18688,3336,28245,"Included"
"2025-07-23T07:58:04.941Z","You","Included in Pro","auto",0,1412,4992,13,6417,"Included"
"2025-07-23T07:25:20.994Z","You","Included in Pro","auto",0,19553,142336,3634,165523,"Included"
"2025-07-23T07:24:49.177Z","You","Included in Pro","auto",0,7200,71168,161,78529,"Included"
"2025-07-23T07:23:48.927Z","You","Included in Pro","auto",0,7699,133504,783,141986,"Included"
"2025-07-23T07:22:48.552Z","You","Included in Pro","auto",0,5770,115328,2279,123377,"Included"
"2025-07-23T07:22:12.975Z","You","Included in Pro","auto",0,12576,96768,2213,111557,"Included"
"2025-07-23T07:20:34.275Z","You","Included in Pro","auto",0,5334,72832,2919,81085,"Included"
"2025-07-23T07:19:27.435Z","You","Included in Pro","auto",0,5376,56064,6434,67874,"Included"
"2025-07-23T07:17:45.759Z","You","Included in Pro","auto",0,35299,52096,4910,92305,"Included"
"2025-07-23T07:16:06.245Z","You","Included in Pro","auto",0,8851,0,69,8920,"Included"
"2025-07-23T06:56:25.501Z","You","Included in Pro","auto",0,15686,17792,5004,38482,"Included"
"2025-07-23T06:41:49.023Z","You","Included in Pro","auto",0,401,36480,280,37161,"Included"
"2025-07-23T06:40:03.131Z","You","Included in Pro","auto",0,9756,329344,1678,340778,"Included"
"2025-07-23T06:39:44.239Z","You","Included in Pro","auto",0,506,85376,258,86140,"Included"
"2025-07-23T06:38:41.203Z","You","Included in Pro","auto",0,33720,480768,1515,516003,"Included"
"2025-07-23T06:34:59.664Z","You","Included in Pro","auto",0,12102,70272,3368,85742,"Included"
"2025-07-23T06:34:10.983Z","You","Errored, Not Charged","auto",0,0,0,0,0,"Included"
"2025-07-23T06:32:51.527Z","You","Included in Pro","auto",0,10721,100608,3105,114434,"Included"
"2025-07-23T06:28:37.922Z","You","Included in Pro","auto",0,5307,78848,5718,89873,"Included"
"2025-07-23T06:25:12.373Z","You","Included in Pro","auto",0,4020,59648,2067,65735,"Included"
"2025-07-23T06:23:00.352Z","You","Included in Pro","auto",0,17161,30592,4775,52528,"Included"
"2025-07-23T06:21:56.867Z","You","Included in Pro","auto",0,11064,99200,1422,111686,"Included"
"2025-07-23T06:17:55.242Z","You","Included in Pro","auto",0,15238,67328,2725,85291,"Included"
"2025-07-23T06:16:05.039Z","You","Included in Pro","auto",0,30228,31360,5831,67419,"Included"
"2025-07-23T06:14:43.197Z","You","Included in Pro","auto",0,8360,144512,4980,157852,"Included"
"2025-07-23T06:13:36.931Z","You","Included in Pro","auto",0,24940,101888,4957,131785,"Included"
"2025-07-23T05:40:08.465Z","You","Included in Pro","auto",0,20828,50560,4300,75688,"Included"
"2025-07-23T05:37:31.808Z","You","Included in Pro","auto",0,18025,139392,2245,159662,"Included"
"2025-07-23T05:13:23.238Z","You","Included in Pro","auto",0,45513,53632,2831,101976,"Included"
"2025-07-22T17:28:39.510Z","You","Included in Pro","auto",0,8894,1024,650,10568,"Included"
"2025-07-22T17:11:21.779Z","You","Included in Pro","auto",0,3477,34688,761,38926,"Included"
"2025-07-22T17:11:02.140Z","You","Included in Pro","auto",0,6721,4736,780,12237,"Included"
"2025-07-22T17:09:11.332Z","You","Included in Pro","auto",0,5400,6272,1335,13007,"Included"
"2025-07-22T17:05:23.953Z","You","Included in Pro","auto",0,7568,42624,3984,54176,"Included"
"2025-07-22T16:57:17.943Z","You","Included in Pro","auto",0,256,20992,87,21335,"Included"
"2025-07-22T16:56:34.936Z","You","Included in Pro","auto",0,9986,28544,2164,40694,"Included"
"2025-07-22T16:55:14.682Z","You","Included in Pro","auto",0,18622,34048,3696,56366,"Included"
"2025-07-22T16:55:11.652Z","You","Aborted, Not Charged","auto",0,0,0,0,0,"Included"
"2025-07-22T13:54:39.660Z","You","Included in Pro","auto",0,18079,24704,2290,45073,"Included"
"2025-07-22T13:02:29.772Z","You","Included in Pro","auto",0,71874,146944,2135,220953,"Included"
"2025-07-22T12:54:10.897Z","You","Included in Pro","auto",0,64915,98432,1568,164915,"Included"
"2025-07-22T12:52:49.073Z","You","Included in Pro","auto",0,27701,57856,1592,87149,"Included"
"2025-07-22T12:52:45.094Z","You","Errored, Not Charged","auto",0,0,0,0,0,"Included"
"2025-07-22T12:36:19.858Z","You","Included in Pro","auto",0,19252,23808,1536,44596,"Included"
"2025-07-22T12:33:14.340Z","You","Included in Pro","auto",0,3630,22400,1151,27181,"Included"
"2025-07-22T11:37:37.820Z","You","Included in Pro","auto",0,4925,65152,2319,72396,"Included"
"2025-07-22T11:35:04.151Z","You","Included in Pro","auto",0,12062,38400,2135,52597,"Included"
"2025-07-22T11:26:20.588Z","You","Included in Pro","auto",0,304,12672,222,13198,"Included"
"2025-07-22T11:24:48.345Z","You","Included in Pro","auto",0,14567,46976,1720,63263,"Included"
"2025-07-22T08:40:00.258Z","You","Included in Pro","auto",0,14620,140544,2278,157442,"Included"
"2025-07-22T08:39:26.867Z","You","Included in Pro","auto",0,5802,4992,463,11257,"Included"
"2025-07-22T08:30:41.222Z","You","Included in Pro","auto",0,3752,11392,102,15246,"Included"
"2025-07-22T08:19:03.495Z","You","Included in Pro","auto",0,949,37504,182,38635,"Included"
"2025-07-22T08:18:34.644Z","You","Included in Pro","auto",0,159,74240,509,74908,"Included"
"2025-07-22T08:17:53.513Z","You","Included in Pro","auto",0,754,36096,65,36915,"Included"
"2025-07-22T08:17:18.267Z","You","Included in Pro","auto",0,35815,36480,622,72917,"Included"
"2025-07-22T08:16:47.502Z","You","Errored, Not Charged","auto",0,0,0,0,0,"Included"
"2025-07-22T08:13:45.885Z","You","Included in Pro","auto",0,34890,47104,3492,85486,"Included"
"2025-07-22T07:44:34.031Z","You","Included in Pro","auto",0,6005,58880,3325,68210,"Included"
"2025-07-22T07:37:16.350Z","You","Included in Pro","auto",0,5447,66176,2837,74460,"Included"
"2025-07-22T07:28:37.558Z","You","Included in Pro","auto",0,15732,49152,2048,66932,"Included"
"2025-07-22T07:23:54.699Z","You","Included in Pro","auto",0,11888,14464,1050,27402,"Included"
"2025-07-22T05:58:57.632Z","You","Included in Pro","auto",0,549,197248,266,198063,"Included"
"2025-07-22T05:57:09.534Z","You","Included in Pro","auto",0,1018,194432,977,196427,"Included"
"2025-07-22T05:56:30.137Z","You","Included in Pro","auto",0,842,192000,511,193353,"Included"
"2025-07-22T05:53:39.441Z","You","Included in Pro","auto",0,29606,137600,10740,177946,"Included"
"2025-07-22T05:47:15.443Z","You","Included in Pro","auto",0,55371,53120,7167,115658,"Included"
"2025-07-22T05:44:46.871Z","You","Included in Pro","auto",0,9244,61568,4311,75123,"Included"
"2025-07-22T05:40:05.147Z","You","Included in Pro","auto",0,7866,43648,6459,57973,"Included"
"2025-07-22T05:39:19.675Z","You","Included in Pro","auto",0,6224,6272,37,12533,"Included"
"2025-07-22T05:33:57.779Z","You","Included in Pro","auto",0,21735,14976,2850,39561,"Included"
"2025-07-21T07:24:30.989Z","You","Included in Pro","auto",0,6829,58112,881,65822,"Included"
"2025-07-21T07:24:15.779Z","You","Included in Pro","auto",0,8500,11392,352,20244,"Included"
"2025-07-21T07:22:05.515Z","You","Included in Pro","auto",0,14288,28160,2469,44917,"Included"
"2025-07-21T07:21:27.822Z","You","Included in Pro","auto",0,5884,7424,95,13403,"Included"
"2025-07-21T06:35:32.968Z","You","Included in Pro","auto",0,17880,94848,4170,116898,"Included"
"2025-07-21T06:33:57.165Z","You","Errored, Not Charged","auto",0,0,0,0,0,"Included"
"2025-07-21T05:28:35.241Z","You","Included in Pro","auto",0,471,35968,180,36619,"Included"
"2025-07-21T05:28:03.322Z","You","Included in Pro","auto",0,1384,33536,185,35105,"Included"
"2025-07-21T05:25:29.401Z","You","Included in Pro","auto",0,6651,21504,5488,33643,"Included"
"2025-07-21T04:08:42.022Z","You","Included in Pro","auto",0,9659,111232,2555,123446,"Included"
"2025-07-21T04:05:05.443Z","You","Included in Pro","auto",0,15437,108672,6365,130474,"Included"
"2025-07-21T03:56:51.658Z","You","Included in Pro","auto",0,7894,50560,4632,63086,"Included"
"2025-07-21T03:08:47.844Z","You","Included in Pro","auto",0,2373,77824,1160,81357,"Included"
"2025-07-21T03:08:21.979Z","You","Included in Pro","auto",0,83,6400,191,6674,"Included"
"2025-07-21T03:07:20.863Z","You","Included in Pro","auto",0,5557,92928,958,99443,"Included"
"2025-07-21T02:58:07.081Z","You","Included in Pro","auto",0,303,14464,122,14889,"Included"
"2025-07-21T02:57:53.393Z","You","Included in Pro","auto",0,626,19712,394,20732,"Included"
"2025-07-21T02:57:38.722Z","You","Included in Pro","auto",0,5297,1024,204,6525,"Included"
"2025-07-20T18:31:24.658Z","You","Included in Pro","auto",0,0,0,0,0,"Included"
"2025-07-20T18:15:09.073Z","You","Included in Pro","auto",0,0,0,0,0,"Included"
"2025-07-20T18:10:14.720Z","You","Included in Pro","auto",0,0,0,0,0,"Included"
"2025-07-20T18:04:26.222Z","You","Included in Pro","auto",0,0,0,0,0,"Included"
"2025-07-20T17:36:04.867Z","You","Errored, Not Charged","auto",0,0,0,0,0,"Included"
"2025-07-20T17:34:11.028Z","You","Included in Pro","auto",0,0,0,0,0,"Included"
"2025-07-20T16:52:08.755Z","You","Included in Pro","auto",0,634,62464,206,63304,"Included"
"2025-07-20T16:48:13.734Z","You","Included in Pro","auto",0,20765,101120,315,122200,"Included"
"2025-07-20T16:46:21.679Z","You","Included in Pro","auto",0,13458,25088,569,39115,"Included"
"2025-07-20T16:46:04.427Z","You","Included in Pro","auto",0,10503,45568,496,56567,"Included"
"2025-07-20T16:45:23.755Z","You","Included in Pro","auto",0,1244,6272,573,8089,"Included"
"2025-07-20T16:39:56.083Z","You","Included in Pro","auto",0,16438,51328,561,68327,"Included"
"2025-07-20T16:39:36.769Z","You","Included in Pro","auto",0,11400,4864,367,16631,"Included"
"2025-07-20T16:22:59.438Z","You","Included in Pro","auto",0,10891,4736,602,16229,"Included"
"2025-07-20T16:10:17.297Z","You","Included in Pro","auto",0,2950,12288,345,15583,"Included"
"2025-07-20T16:09:11.074Z","You","Included in Pro","auto",0,10871,39424,820,51115,"Included"
"2025-07-20T16:08:41.912Z","You","Included in Pro","auto",0,452,6144,387,6983,"Included"
"2025-07-20T16:02:38.176Z","You","Included in Pro","auto",0,11323,165376,5566,182265,"Included"
"2025-07-20T15:58:51.531Z","You","Included in Pro","auto",0,21415,69504,6338,97257,"Included"
"2025-07-20T15:58:15.262Z","You","Included in Pro","auto",0,28,13056,252,13336,"Included"
"2025-07-20T15:58:03.103Z","You","Included in Pro","auto",0,6788,6144,132,13064,"Included"
"2025-07-20T15:54:46.879Z","You","Included in Pro","auto",0,5384,95104,6081,106569,"Included"
"2025-07-20T15:52:36.824Z","You","Included in Pro","auto",0,31888,44288,4005,80181,"Included"
"2025-07-20T15:50:59.411Z","You","Included in Pro","auto",0,6272,48640,3431,58343,"Included"
"2025-07-20T15:49:41.617Z","You","Included in Pro","auto",0,6587,29056,3575,39218,"Included"
"2025-07-20T15:48:23.639Z","You","Included in Pro","auto",0,8581,10496,1879,20956,"Included"
"2025-07-20T15:44:01.097Z","You","Included in Pro","auto",0,4850,4864,1168,10882,"Included"
"2025-07-18T16:39:37.220Z","You","Included in Pro","auto",0,300,15104,350,15754,"Included"
"2025-07-18T16:38:25.923Z","You","Included in Pro","auto",0,19938,45312,1269,66519,"Included"
"2025-07-18T16:36:27.942Z","You","Included in Pro","auto",0,23547,26496,1741,51784,"Included"
"2025-07-18T16:19:06.755Z","You","Included in Pro","auto",0,31150,53632,1615,86397,"Included"
"2025-07-18T16:14:58.635Z","You","Included in Pro","auto",0,958,48000,235,49193,"Included"
"2025-07-18T16:14:13.457Z","You","Included in Pro","auto",0,2392,43264,1827,47483,"Included"
"2025-07-18T16:10:08.396Z","You","Included in Pro","auto",0,13542,41728,1928,57198,"Included"
"2025-07-18T16:07:23.574Z","You","Included in Pro","auto",0,3180,35456,1500,40136,"Included"
"2025-07-18T16:04:48.777Z","You","Included in Pro","auto",0,6892,19328,1164,27384,"Included"
"2025-07-18T16:01:08.636Z","You","Included in Pro","auto",0,205,33664,51,33920,"Included"
"2025-07-18T16:00:33.390Z","You","Included in Pro","auto",0,28872,34048,2856,65776,"Included"
"2025-07-18T15:59:04.923Z","You","Included in Pro","auto",0,24099,33280,263,57642,"Included"
"2025-07-18T15:36:28.632Z","You","Included in Pro","auto",0,18213,25600,3993,47806,"Included"
"2025-07-18T15:31:10.464Z","You","Included in Pro","auto",0,44658,95744,1731,142133,"Included"
"2025-07-18T14:58:54.597Z","You","Included in Pro","auto",0,6224,51968,6504,64696,"Included"
"2025-07-18T14:54:44.337Z","You","Included in Pro","auto",0,215,18944,631,19790,"Included"
"2025-07-18T14:42:09.613Z","You","Included in Pro","auto",0,11365,19456,6144,36965,"Included"
"2025-07-18T14:00:45.949Z","You","Included in Pro","auto",0,2655,109568,743,112966,"Included"
"2025-07-18T13:59:39.339Z","You","Included in Pro","auto",0,6621,51840,486,58947,"Included"
"2025-07-18T13:56:55.672Z","You","Included in Pro","auto",0,4044,106752,1798,112594,"Included"
"2025-07-18T13:56:36.816Z","You","Errored, Not Charged","auto",0,0,0,0,0,"Included"
"2025-07-18T13:55:06.526Z","You","Included in Pro","auto",0,1515,94976,1297,97788,"Included"
"2025-07-18T13:53:34.758Z","You","Included in Pro","auto",0,8200,97408,2446,108054,"Included"
"2025-07-18T13:52:33.973Z","You","Included in Pro","auto",0,4433,63872,1420,69725,"Included"
"2025-07-18T13:51:23.135Z","You","Included in Pro","auto",0,2897,55424,427,58748,"Included"
"2025-07-18T13:50:32.909Z","You","Included in Pro","auto",0,831,26240,234,27305,"Included"
"2025-07-18T13:46:48.212Z","You","Included in Pro","auto",0,13012,23040,1584,37636,"Included"
"2025-07-18T13:45:53.156Z","You","Included in Pro","auto",0,4123,34688,619,39430,"Included"
"2025-07-18T13:45:07.127Z","You","Included in Pro","auto",0,9931,4864,591,15386,"Included"
"2025-07-18T13:32:21.345Z","You","Included in Pro","auto",0,32003,50176,1812,83991,"Included"
"2025-07-18T13:01:37.327Z","You","Included in Pro","auto",0,5483,1024,1259,7766,"Included"
"2025-07-18T10:01:08.474Z","You","Errored, Not Charged","auto",0,0,0,0,0,"Included"
"2025-07-18T09:23:20.593Z","You","Included in Pro","auto",0,21753,44928,5315,71996,"Included"
"2025-07-18T09:20:13.645Z","You","Included in Pro","auto",0,12362,9728,853,22943,"Included"
"2025-07-18T08:54:07.064Z","You","Included in Pro","auto",0,6367,138496,1796,146659,"Included"
"2025-07-18T08:53:04.060Z","You","Included in Pro","auto",0,2841,32512,131,35484,"Included"
"2025-07-18T08:47:54.763Z","You","Included in Pro","auto",0,1540,28032,1416,30988,"Included"
"2025-07-18T08:43:37.503Z","You","Included in Pro","auto",0,12462,12032,1248,25742,"Included"
"2025-07-18T08:40:24.336Z","You","Included in Pro","auto",0,846,19840,687,21373,"Included"
"2025-07-18T08:34:36.190Z","You","Included in Pro","auto",0,1698,14336,1612,17646,"Included"
"2025-07-18T08:28:06.748Z","You","Included in Pro","auto",0,6070,12928,1809,20807,"Included"
"2025-07-18T04:39:21.349Z","You","Included in Pro","auto",0,0,0,0,0,"Included"
"2025-07-18T04:34:33.264Z","You","Included in Pro","auto",0,0,0,0,0,"Included"
"2025-07-18T04:30:14.995Z","You","Included in Pro","auto",0,0,0,0,0,"Included"
"2025-07-18T04:09:08.203Z","You","Included in Pro","auto",0,0,0,0,0,"Included"
"2025-07-17T14:27:16.402Z","You","Included in Pro","auto",0,2980,82560,3118,88658,"Included"
"2025-07-17T14:25:46.060Z","You","Included in Pro","auto",0,39073,0,114,39187,"Included"
"2025-07-17T14:23:38.930Z","You","Included in Pro","auto",0,607,76928,656,78191,"Included"
"2025-07-17T14:23:11.143Z","You","Included in Pro","auto",0,765,111488,800,113053,"Included"
"2025-07-17T14:15:58.081Z","You","Included in Pro","auto",0,2253,131328,2832,136413,"Included"
"2025-07-17T14:15:28.894Z","You","Included in Pro","auto",0,106,31360,545,32011,"Included"
"2025-07-17T14:14:43.067Z","You","Included in Pro","auto",0,1281,57984,2230,61495,"Included"
"2025-07-17T14:13:18.926Z","You","Included in Pro","auto",0,642,54528,490,55660,"Included"
"2025-07-17T14:12:54.138Z","You","Included in Pro","auto",0,130,26624,139,26893,"Included"
"2025-07-17T14:11:19.603Z","You","Included in Pro","auto",0,4014,41472,3798,49284,"Included"
"2025-07-17T14:10:48.718Z","You","Included in Pro","auto",0,234,18432,294,18960,"Included"
"2025-07-17T14:09:53.087Z","You","Included in Pro","auto",0,11514,6144,798,18456,"Included"
"2025-07-17T14:07:00.768Z","You","Included in Pro","auto",0,9464,9600,4414,23478,"Included"
"2025-07-17T14:03:21.083Z","You","Included in Pro","auto",0,165,69120,292,69577,"Included"
"2025-07-17T13:58:58.625Z","You","Included in Pro","auto",0,122,68608,441,69171,"Included"
"2025-07-17T13:58:10.402Z","You","Included in Pro","auto",0,258,68096,259,68613,"Included"
"2025-07-17T13:55:19.111Z","You","Included in Pro","auto",0,8058,184704,1846,194608,"Included"
"2025-07-17T13:53:54.078Z","You","Included in Pro","auto",0,217,58112,204,58533,"Included"
"2025-07-17T13:52:16.859Z","You","Included in Pro","auto",0,7956,153472,2743,164171,"Included"
"2025-07-17T13:51:10.752Z","You","Included in Pro","auto",0,8646,121728,1708,132082,"Included"
"2025-07-17T13:50:21.884Z","You","Included in Pro","auto",0,1293,110464,168,111925,"Included"
"2025-07-17T13:50:02.563Z","You","Included in Pro","auto",0,213,35968,123,36304,"Included"
"2025-07-17T13:48:57.046Z","You","Included in Pro","auto",0,31803,59392,3380,94575,"Included"
"2025-07-17T13:22:33.354Z","You","Included in Pro","auto",0,12162,120064,3700,135926,"Included"
"2025-07-17T13:22:20.052Z","You","Included in Pro","auto",0,8445,10624,470,19539,"Included"
"2025-07-17T13:22:10.438Z","You","Included in Pro","auto",0,9141,8448,238,17827,"Included"
"2025-07-17T13:21:10.064Z","You","Included in Pro","auto",0,924,76160,838,77922,"Included"
"2025-07-17T13:19:46.684Z","You","Included in Pro","auto",0,36354,104320,495,141169,"Included"
"2025-07-17T10:48:43.516Z","You","Included in Pro","auto",0,13311,39936,754,54001,"Included"
"2025-07-17T10:45:26.206Z","You","Included in Pro","auto",0,29669,315392,2062,347123,"Included"
"2025-07-16T16:30:17.612Z","You","Included in Pro","auto",0,5709,44800,979,51488,"Included"
"2025-07-16T16:29:17.800Z","You","Included in Pro","auto",0,12126,0,697,12823,"Included"
"2025-07-16T16:06:38.653Z","You","Included in Pro","auto",0,25355,30592,209,56156,"Included"
"2025-07-16T12:10:14.251Z","You","Included in Pro","auto",0,1259,33024,253,34536,"Included"
"2025-07-16T12:09:40.038Z","You","Included in Pro","auto",0,7193,17408,960,25561,"Included"
"2025-07-16T12:08:01.451Z","You","Included in Pro","auto",0,1045,109824,186,111055,"Included"
"2025-07-16T12:07:00.853Z","You","Included in Pro","auto",0,523,53248,151,53922,"Included"
"2025-07-16T12:06:43.786Z","You","Included in Pro","auto",0,438,25856,149,26443,"Included"
"2025-07-16T12:01:08.606Z","You","Included in Pro","auto",0,20921,56192,225,77338,"Included"
"2025-07-16T10:38:20.023Z","You","Included in Pro","auto",0,58218,109568,1475,169261,"Included"
"2025-07-16T09:47:49.871Z","You","Included in Pro","auto",0,26558,61312,1919,89789,"Included"
"2025-07-16T09:38:13.668Z","You","Included in Pro","auto",0,1322,245504,257,247083,"Included"
"2025-07-16T09:37:05.922Z","You","Included in Pro","auto",0,592,144640,229,145461,"Included"
"2025-07-16T09:36:16.167Z","You","Included in Pro","auto",0,1151,140032,1096,142279,"Included"
"2025-07-16T09:35:01.949Z","You","Included in Pro","auto",0,2155,85632,2486,90273,"Included"
"2025-07-16T09:34:01.884Z","You","Included in Pro","auto",0,464,82048,362,82874,"Included"
"2025-07-16T09:32:59.534Z","You","Included in Pro","auto",0,1180,117248,1375,119803,"Included"
"2025-07-16T09:32:04.209Z","You","Included in Pro","auto",0,3062,67840,3334,74236,"Included"
"2025-07-16T09:24:56.292Z","You","Included in Pro","auto",0,1922,85120,3782,90824,"Included"
"2025-07-16T09:21:02.441Z","You","Included in Pro","auto",0,3837,112512,3996,120345,"Included"
"2025-07-16T09:01:22.544Z","You","Included in Pro","auto",0,558,22272,747,23577,"Included"
"2025-07-16T09:00:39.193Z","You","Included in Pro","auto",0,1583,4224,1252,7059,"Included"
"2025-07-16T08:57:13.247Z","You","Errored, Not Charged","auto",0,0,0,0,0,"Included"
"2025-07-14T11:57:19.204Z","You","Included in Pro","claude-4-sonnet",23794,34,262586,3186,289600,"Included"
"2025-07-14T11:41:20.479Z","You","Included in Pro","claude-4-sonnet",105178,52,2838640,10718,2954588,"Included"
"2025-07-14T11:31:46.180Z","You","Included in Pro","claude-4-sonnet",84820,248,2786034,19587,2890689,"Included"
"2025-07-14T11:26:27.213Z","You","Included in Pro","claude-4-sonnet",26581,21,45235,4728,76565,"Included"
"2025-07-14T11:17:12.785Z","You","Included in Pro","gemini-2.5-pro-preview-05-06",0,8388,42314,1070,51772,"Included"
"2025-07-14T11:15:50.174Z","You","Included in Pro","gemini-2.5-pro-preview-05-06",0,12612,51896,732,65240,"Included"
"2025-07-14T11:11:28.067Z","You","Included in Pro","gemini-2.5-pro-preview-05-06",0,51857,356358,6362,414577,"Included"
"2025-07-14T11:08:33.523Z","You","Included in Pro","gemini-2.5-pro-preview-05-06",0,24075,141783,3545,169403,"Included"
"2025-07-14T11:06:32.225Z","You","Included in Pro","gemini-2.5-pro-preview-05-06",0,3266,13766,450,17482,"Included"
"2025-07-14T10:36:57.518Z","You","Included in Pro","gemini-2.5-pro-preview-05-06",0,30786,234056,2197,267039,"Included"
"2025-07-14T10:35:13.261Z","You","Included in Pro","gemini-2.5-pro-preview-05-06",0,2789,11158,255,14202,"Included"
"2025-07-14T10:30:43.802Z","You","Included in Pro","gemini-2.5-pro-preview-05-06",0,27345,195177,4245,226767,"Included"
"2025-07-14T10:17:52.174Z","You","Included in Pro","gemini-2.5-pro-preview-05-06",0,8954,52272,1401,62627,"Included"
"2025-07-14T09:53:03.723Z","You","Included in Pro","claude-4-sonnet",91741,59,1515388,46152,1653340,"Included"
"2025-07-13T17:40:21.503Z","You","Included in Pro","gemini-2.5-pro-preview-05-06",0,64084,505646,7670,577400,"Included"
"2025-07-13T17:35:37.931Z","You","Included in Pro","gemini-2.5-pro-preview-05-06",0,46674,313796,9462,369932,"Included"
"2025-07-13T17:29:16.709Z","You","Included in Pro","claude-4-sonnet",74271,47,2514584,12396,2601298,"Included"
"2025-07-13T17:21:42.867Z","You","Included in Pro","claude-4-sonnet",108814,40,1041973,3742,1154569,"Included"
"2025-07-13T17:02:59.002Z","You","Included in Pro","claude-4-sonnet",78652,37,2055345,54147,2188181,"Included"
"2025-07-13T16:58:21.430Z","You","Included in Pro","grok-4-0709",0,4523,417,2880,7820,"Included"
"2025-07-13T10:58:38.506Z","You","Included in Pro","claude-4-sonnet-thinking",71311,141,1375500,20403,1467355,"Included"
"2025-07-13T10:53:31.670Z","You","Included in Pro","gemini-2.5-pro-preview-05-06",0,17898,100219,2442,120559,"Included"
"2025-07-13T10:36:10.660Z","You","Included in Pro","gemini-2.5-pro-preview-05-06",0,141209,1260393,16224,1417826,"Included"
"2025-07-13T10:30:44.007Z","You","Included in Pro","grok-4-0709",0,120911,30940,805,152656,"Included"
"2025-07-13T10:27:57.593Z","You","Included in Pro","gpt-4.1",0,2772,98816,451,102039,"Included"
"2025-07-13T10:27:43.636Z","You","Included in Pro","gpt-4.1",0,93,24576,337,25006,"Included"
"2025-07-13T10:26:45.355Z","You","Errored, Not Charged","gpt-4.1",0,0,0,0,0,"Included"
"2025-07-13T10:26:08.040Z","You","Included in Pro","gpt-4.1",0,191,23936,355,24482,"Included"
"2025-07-13T10:25:05.528Z","You","Included in Pro","gpt-4.1",0,23378,80896,919,105193,"Included"
"2025-07-13T10:19:12.807Z","You","Included in Pro","gpt-4.1",0,8484,36480,409,45373,"Included"
"2025-07-13T10:17:35.996Z","You","Included in Pro","gpt-4.1",0,1302,29568,245,31115,"Included"
"2025-07-13T10:14:14.151Z","You","Included in Pro","gpt-4.1",0,5981,31488,542,38011,"Included"
"2025-07-13T10:13:47.492Z","You","Included in Pro","gpt-4.1",0,3960,4224,635,8819,"Included"
"2025-07-13T08:13:15.991Z","You","Included in Pro","gemini-2.5-pro-preview-05-06",0,11407,74966,721,87094,"Included"
"2025-07-13T08:10:32.898Z","You","Included in Pro","gemini-2.5-pro-preview-05-06",0,33765,170037,2233,206035,"Included"
"2025-07-13T08:06:43.858Z","You","Included in Pro","gemini-2.5-pro-preview-05-06",0,7516,30072,796,38384,"Included"
"2025-07-13T08:04:37.540Z","You","Included in Pro","gemini-2.5-pro-preview-05-06",0,3362,20780,432,24574,"Included"
"2025-07-13T08:02:21.306Z","You","Included in Pro","gemini-2.5-pro-preview-05-06",0,4181,16729,448,21358,"Included"
"2025-07-13T08:00:13.146Z","You","Included in Pro","gemini-2.5-pro-preview-05-06",0,9206,38425,898,48529,"Included"
"2025-07-13T07:58:42.204Z","You","Errored, Not Charged","gemini-2.5-pro-preview-05-06",0,0,0,0,0,"Included"
"2025-07-13T07:55:35.965Z","You","Included in Pro","gemini-2.5-pro-preview-05-06",0,7224,31406,749,39379,"Included"
"2025-07-13T07:38:24.839Z","You","Included in Pro","claude-4-sonnet",82180,47,2350736,33215,2466178,"Included"
"2025-07-13T07:32:31.406Z","You","Included in Pro","gemini-2.5-pro-preview-05-06",0,56838,832224,3868,892930,"Included"
"2025-07-13T07:27:19.766Z","You","Included in Pro","gemini-2.5-pro-preview-05-06",0,58138,671956,2208,732302,"Included"
"2025-07-13T07:25:03.268Z","You","Included in Pro","gemini-2.5-pro-preview-05-06",0,20162,143877,981,165020,"Included"
"2025-07-13T07:21:34.543Z","You","Included in Pro","gemini-2.5-pro-preview-05-06",0,31597,144250,4601,180448,"Included"
"2025-07-13T07:15:37.599Z","You","Included in Pro","claude-4-sonnet",34051,64,902398,10007,946520,"Included"
"2025-07-13T07:08:42.262Z","You","Included in Pro","claude-4-sonnet",50919,80,1924350,13384,1988733,"Included"
"2025-07-13T06:52:30.322Z","You","Included in Pro","claude-4-sonnet",74928,19,1200435,37213,1312595,"Included"
"2025-07-13T01:55:11.153Z","You","Included in Pro","grok-4-0709",0,261756,5603,1511,268870,"Included"
"2025-07-13T01:36:01.487Z","You","Included in Pro","gemini-2.5-pro-preview-05-06",0,3826,15309,1701,20836,"Included"
"2025-07-13T01:18:20.736Z","You","Included in Pro","gemini-2.5-pro-preview-05-06",0,4264,17056,3119,24439,"Included"
"2025-07-13T01:08:55.182Z","You","Included in Pro","gemini-2.5-pro-preview-05-06",0,5998,23999,2687,32684,"Included"
"2025-07-13T01:03:11.165Z","You","Included in Pro","gemini-2.5-pro-preview-05-06",0,3645,14586,2837,21068,"Included"
"2025-07-13T00:58:40.688Z","You","Included in Pro","gemini-2.5-pro-preview-05-06",0,4199,16804,2064,23067,"Included"
"2025-07-12T17:58:05.144Z","You","Included in Pro","gemini-2.5-pro-preview-05-06",0,27132,149591,18019,194742,"Included"
"2025-07-12T15:41:13.716Z","You","Included in Pro","gemini-2.5-pro-preview-05-06",0,90548,918355,11563,1020466,"Included"
"2025-07-12T15:37:50.604Z","You","Included in Pro","claude-4-sonnet",199477,136,37662,1600,238875,"Included"
"2025-07-12T15:31:09.245Z","You","Included in Pro","grok-4-0709",0,184353,54740,1832,240925,"Included"
"2025-07-12T14:54:19.491Z","You","Included in Pro","claude-4-sonnet",24324,9,32058,11050,67441,"Included"
"2025-07-12T14:47:40.943Z","You","Included in Pro","claude-4-sonnet",52483,91,1115566,8802,1176942,"Included"
"2025-07-12T14:40:22.639Z","You","Included in Pro","claude-4-sonnet",18960,136,1747352,11625,1778073,"Included"
"2025-07-12T14:28:09.729Z","You","Included in Pro","claude-4-sonnet",64377,25,378763,31512,474677,"Included"
"2025-07-12T14:22:53.596Z","You","Included in Pro","claude-4-sonnet",6795,3168,402668,2409,415040,"Included"
"2025-07-12T14:19:17.293Z","You","Included in Pro","claude-4-sonnet",8840,1916,441082,4736,456574,"Included"
"2025-07-12T14:17:04.357Z","You","Included in Pro","claude-4-sonnet",3143,1465,126775,1384,132767,"Included"
"2025-07-12T14:16:36.238Z","You","Included in Pro","claude-4-sonnet",451,1369,40898,716,43434,"Included"
"2025-07-12T14:13:19.561Z","You","Included in Pro","claude-4-sonnet",4957,882,230346,2672,238857,"Included"
"2025-07-12T14:06:15.576Z","You","Included in Pro","claude-4-sonnet",26783,51,509350,12510,548694,"Included"
"2025-07-12T14:05:34.940Z","You","Included in Pro","grok-4-0709",0,4428,507,86,5021,"Included"
"2025-07-12T14:02:20.251Z","You","Included in Pro","gpt-4.1",0,40433,45056,2219,87708,"Included"
"2025-07-12T13:58:59.665Z","You","Included in Pro","grok-4-0709",0,131414,41674,1815,174903,"Included"
"2025-07-12T13:56:56.380Z","You","Included in Pro","grok-4-0709",0,56012,9764,565,66341,"Included"
"2025-07-12T13:52:46.034Z","You","Included in Pro","grok-4-0709",0,58240,5419,442,64101,"Included"
"2025-07-12T13:46:35.247Z","You","Included in Pro","grok-4-0709",0,107088,68529,2366,177983,"Included"
"2025-07-12T13:46:17.522Z","You","Errored, Not Charged","grok-4-0709",0,0,0,0,0,"Included"
"2025-07-12T13:43:07.311Z","You","Included in Pro","grok-4-0709",0,70956,19238,2184,92378,"Included"
"2025-07-12T13:30:59.053Z","You","Included in Pro","grok-4-0709",0,118417,10525,633,129575,"Included"
"2025-07-12T13:27:41.762Z","You","Included in Pro","grok-4-0709",0,15707,834,2100,18641,"Included"
"2025-07-12T13:27:30.584Z","You","Errored, Not Charged","grok-4-0709",0,0,0,0,0,"Included"
"2025-07-12T13:24:55.403Z","You","Included in Pro","grok-4-0709",0,10927,834,750,12511,"Included"
"2025-07-12T04:47:45.156Z","You","Included in Pro","grok-4-0709",0,35134,834,598,36566,"Included"
"2025-07-12T04:31:58.198Z","You","Included in Pro","grok-4-0709",0,36583,1251,1973,39807,"Included"
"2025-07-11T17:56:14.440Z","You","Included in Pro","claude-4-sonnet",2719,142,41860,1555,46276,"Included"
"2025-07-11T17:54:49.242Z","You","Included in Pro","claude-4-sonnet",3738,15,33948,1244,38945,"Included"
"2025-07-11T17:54:41.853Z","You","Errored, Not Charged","claude-4-sonnet",0,0,0,0,0,"Included"
"2025-07-11T17:51:09.765Z","You","Included in Pro","claude-4-sonnet",14081,15,23726,1693,39515,"Included"
"2025-07-11T17:46:03.026Z","You","Included in Pro","grok-4-0709",0,14087,5049,410,19546,"Included"
"2025-07-11T17:35:17.528Z","You","Included in Pro","grok-4-0709",0,22319,16499,1685,40503,"Included"
"2025-07-11T17:28:40.474Z","You","Included in Pro","grok-4-0709",0,24512,19439,1206,45157,"Included"
"2025-07-11T17:26:56.558Z","You","Included in Pro","grok-4-0709",0,10872,21465,727,33064,"Included"
"2025-07-11T17:17:07.710Z","You","Included in Pro","grok-4-0709",0,17733,13006,428,31167,"Included"
"2025-07-11T17:14:09.335Z","You","Included in Pro","grok-4-0709",0,10655,12578,2846,26079,"Included"
"2025-07-11T17:09:49.068Z","You","Included in Pro","grok-4-0709",0,42738,10710,2004,55452,"Included"
"2025-07-11T17:06:35.424Z","You","Included in Pro","grok-4-0709",0,6153,417,1372,7942,"Included"
"2025-07-11T16:59:12.690Z","You","Included in Pro","grok-4-0709",0,40924,7106,449,48479,"Included"
"2025-07-11T10:05:01.234Z","You","Included in Pro","claude-4-sonnet",9214,33,87110,1221,97578,"Included"
"2025-07-11T10:02:18.418Z","You","Included in Pro","grok-4-0709",0,31574,32972,81,64627,"Included"
"2025-07-11T09:34:44.463Z","You","Included in Pro","grok-4-0709",0,59474,6028,6725,72227,"Included"
"2025-07-11T09:12:14.281Z","You","Included in Pro","grok-4-0709",0,20658,5840,6000,32498,"Included"
"2025-07-11T08:22:57.019Z","You","Included in Pro","gemini-2.5-pro-preview-05-06",0,18696,125265,5646,149607,"Included"
"2025-07-11T08:04:44.797Z","You","Included in Pro","gemini-2.5-pro-preview-05-06",0,61986,456599,9910,528495,"Included"
"2025-07-11T08:00:04.459Z","You","Included in Pro","claude-4-sonnet-thinking",24113,505,279761,11267,315646,"Included"
"2025-07-11T07:55:13.975Z","You","Included in Pro","claude-4-sonnet-thinking",67944,594,320153,4270,392961,"Included"
"2025-07-11T07:46:33.739Z","You","Included in Pro","claude-4-sonnet-thinking",50670,154,443720,22043,516587,"Included"
"2025-07-11T07:39:36.616Z","You","Included in Pro","claude-4-sonnet",7984,41,93745,3431,105201,"Included"
"2025-07-10T17:41:36.528Z","You","Included in Pro","claude-4-sonnet",5142,1216,525129,1834,533321,"Included"
"2025-07-10T17:38:53.233Z","You","Included in Pro","claude-4-sonnet",8404,458,313211,4501,326574,"Included"
"2025-07-10T17:33:45.788Z","You","Included in Pro","claude-4-sonnet",38963,138,456794,16086,511981,"Included"
"2025-07-10T15:13:13.472Z","You","Included in Pro","claude-4-sonnet",14022,2897,84330,8870,110119,"Included"
"2025-07-10T15:05:08.502Z","You","Included in Pro","claude-4-sonnet",32650,205,411930,14849,459634,"Included"
"2025-07-10T15:00:23.476Z","You","Included in Pro","claude-4-sonnet",22515,537,1339911,7611,1370574,"Included"
"2025-07-10T14:52:48.171Z","You","Included in Pro","claude-4-sonnet",30386,248,1071520,10800,1112954,"Included"
"2025-07-10T14:46:55.479Z","You","Included in Pro","claude-4-sonnet",51342,3052,1370498,13718,1438610,"Included"
"2025-07-10T14:39:24.717Z","You","Included in Pro","gemini-2.5-pro-preview-05-06",0,160294,1539765,9441,1709500,"Included"
"2025-07-10T14:39:21.021Z","You","Errored, Not Charged","gemini-2.5-pro-preview-05-06",0,0,0,0,0,"Included"
"2025-07-10T14:35:29.252Z","You","Included in Pro","claude-4-sonnet",52351,608,355178,5004,413141,"Included"
"2025-07-10T14:30:57.183Z","You","Included in Pro","claude-4-sonnet",44657,382,761966,11878,818883,"Included"
"2025-07-10T14:30:44.324Z","You","Errored, Not Charged","claude-4-sonnet",0,0,0,0,0,"Included"
"2025-07-10T14:19:52.424Z","You","Included in Pro","claude-4-sonnet",75503,419,1634213,24994,1735129,"Included"
"2025-07-10T14:06:14.648Z","You","Included in Pro","claude-4-sonnet",163610,3703,889294,40418,1097025,"Included"
"2025-07-10T13:51:53.952Z","You","Included in Pro","claude-4-sonnet",87036,4023,1408002,34031,1533092,"Included"
"2025-07-10T13:47:51.478Z","You","Included in Pro","claude-4-sonnet",79970,1304,149101,7728,238103,"Included"
"2025-07-10T13:28:07.619Z","You","Included in Pro","claude-4-sonnet",140765,3470,827427,65723,1037385,"Included"
"2025-07-10T13:15:46.933Z","You","Included in Pro","claude-4-sonnet",49429,920,1141305,15364,1207018,"Included"
"2025-07-10T13:04:08.416Z","You","Included in Pro","claude-4-sonnet",50616,180,1031348,25925,1108069,"Included"
"2025-07-10T12:53:38.126Z","You","Included in Pro","claude-4-sonnet",56439,4476,850517,15290,926722,"Included"
"2025-07-10T12:34:56.659Z","You","Included in Pro","claude-4-sonnet",69307,1877,936286,26149,1033619,"Included"
"2025-07-10T12:28:58.211Z","You","Included in Pro","claude-4-sonnet",60874,719,952539,7133,1021265,"Included"
"2025-07-10T11:58:31.710Z","You","Included in Pro","claude-4-sonnet",136218,1564,2865509,59831,3063122,"Included"
"2025-07-10T11:52:44.194Z","You","Included in Pro","gemini-2.5-pro-preview-05-06",0,18096,90632,4815,113543,"Included"
"2025-07-10T11:48:59.670Z","You","Included in Pro","gemini-2.5-pro-preview-05-06",0,7139,28570,5700,41409,"Included"
"2025-07-10T11:46:25.119Z","You","Included in Pro","gemini-2.5-pro-preview-05-06",0,846,3385,103,4334,"Included"
"2025-07-10T11:40:14.715Z","You","Included in Pro","gemini-2.5-pro-preview-05-06",0,1330,5320,1361,8011,"Included"
"2025-07-10T11:02:26.609Z","You","Included in Pro","gemini-2.5-pro-preview-05-06",0,482,42499,43,43024,"Included"
"2025-07-10T11:01:37.241Z","You","Included in Pro","gemini-2.5-pro-preview-05-06",0,4564,38262,51,42877,"Included"
"2025-07-10T11:00:07.541Z","You","Included in Pro","gemini-2.5-pro-preview-05-06",0,9233,76568,497,86298,"Included"
"2025-07-10T10:55:51.956Z","You","Included in Pro","gemini-2.5-pro-preview-05-06",0,7819,76606,180,84605,"Included"
"2025-07-10T10:53:37.397Z","You","Included in Pro","gemini-2.5-pro-preview-05-06",0,17754,106509,1016,125279,"Included"
"2025-07-10T10:49:53.819Z","You","Included in Pro","gemini-2.5-pro-preview-05-06",0,10441,57822,1753,70016,"Included"
"2025-07-10T10:48:50.165Z","You","Included in Pro","gemini-2.5-pro-preview-05-06",0,15384,100155,2670,118209,"Included"
"2025-07-10T10:47:09.898Z","You","Included in Pro","gemini-2.5-pro-preview-05-06",0,7010,28043,880,35933,"Included"
"2025-07-10T10:37:53.640Z","You","Included in Pro","gemini-2.5-pro-preview-05-06",0,36152,234028,2325,272505,"Included"
"2025-07-10T10:33:45.518Z","You","Included in Pro","claude-4-sonnet-thinking",7531,2394,18947,1995,30867,"Included"
"2025-07-10T10:30:51.801Z","You","Included in Pro","claude-4-sonnet-thinking",23517,436,248251,2654,274858,"Included"
"2025-07-10T10:21:31.029Z","You","Included in Pro","claude-4-sonnet-thinking",110020,937,1692460,9657,1813074,"Included"
"2025-07-10T10:04:46.444Z","You","Included in Pro","claude-4-sonnet-thinking",80837,498,1582896,35309,1699540,"Included"
"2025-07-10T10:02:19.665Z","You","Included in Pro","claude-4-sonnet",17198,314,61014,2315,80841,"Included"
"2025-07-10T10:00:44.417Z","You","Included in Pro","claude-4-sonnet",17101,252,38371,2082,57806,"Included"
"2025-07-10T09:56:57.646Z","You","Errored, Not Charged","claude-4-sonnet",0,0,0,0,0,"Included"
"2025-07-10T09:43:26.854Z","You","Included in Pro","claude-4-sonnet",54313,1364,828780,19616,904073,"Included"
"2025-07-10T09:24:10.008Z","You","Included in Pro","claude-4-sonnet",21281,337,386990,7154,415762,"Included"
"2025-07-10T08:54:05.711Z","You","Included in Pro","claude-4-sonnet",60150,94,1436754,33095,1530093,"Included"
"2025-07-09T08:24:31.460Z","You","Included in Pro","gemini-2.5-pro-preview-05-06",0,5187,24908,574,30669,"Included"
"2025-07-09T08:18:57.177Z","You","Included in Pro","gemini-2.5-pro-preview-05-06",0,1691,6764,488,8943,"Included"
"2025-07-09T08:16:35.705Z","You","Included in Pro","gemini-2.5-pro-preview-05-06",0,2275,9106,1734,13115,"Included"
"2025-07-09T08:11:19.486Z","You","Included in Pro","gemini-2.5-pro-preview-05-06",0,70804,465555,6304,542663,"Included"
"2025-07-09T08:00:19.156Z","You","Included in Pro","gemini-2.5-pro-preview-05-06",0,66738,401095,5402,473235,"Included"
"2025-07-09T08:00:12.728Z","You","Errored, Not Charged","gemini-2.5-pro-preview-05-06",0,0,0,0,0,"Included"
"2025-07-09T07:55:57.633Z","You","Included in Pro","gemini-2.5-pro-preview-05-06",0,24719,105359,6262,136340,"Included"
"2025-07-09T07:50:03.149Z","You","Included in Pro","o3",0,9752,18332,5023,33107,"Included"
"2025-07-09T07:04:45.807Z","You","Included in Pro","gemini-2.5-pro-preview-05-06",0,13179,149300,1397,163876,"Included"
"2025-07-09T07:01:02.401Z","You","Included in Pro","gemini-2.5-pro-preview-05-06",0,55015,519597,4776,579388,"Included"
"2025-07-09T06:56:07.591Z","You","Included in Pro","gemini-2.5-pro-preview-05-06",0,44671,322923,6987,374581,"Included"
"2025-07-09T06:50:26.058Z","You","Included in Pro","gemini-2.5-pro-preview-05-06",0,14834,62803,3606,81243,"Included"
"2025-07-09T06:45:36.900Z","You","Included in Pro","gemini-2.5-pro-preview-05-06",0,25525,149265,6810,181600,"Included"
"2025-07-09T06:41:30.521Z","You","Included in Pro","gemini-2.5-pro-preview-05-06",0,2639,10557,1221,14417,"Included"
"2025-07-09T06:40:04.025Z","You","Included in Pro","gemini-2.5-pro-preview-05-06",0,4846,19392,1133,25371,"Included"
"2025-07-08T14:55:47.720Z","You","Included in Pro","o3",0,13199,34844,6947,54990,"Included"
"2025-07-08T14:51:12.462Z","You","Included in Pro","o3",0,3637,5812,1935,11384,"Included"
"2025-07-08T14:46:28.925Z","You","Included in Pro","o3",0,15336,35484,2302,53122,"Included"
"2025-07-08T14:42:44.412Z","You","Included in Pro","o3",0,3958,32796,779,37533,"Included"
"2025-07-08T14:38:12.119Z","You","Included in Pro","o3",0,3462,16104,945,20511,"Included"
"2025-07-08T14:35:19.643Z","You","Included in Pro","o3",0,1336,33000,555,34891,"Included"
"2025-07-08T14:34:03.243Z","You","Included in Pro","o3",0,1185,47900,958,50043,"Included"
"2025-07-08T14:33:18.425Z","You","Included in Pro","o3",0,805,30824,481,32110,"Included"
"2025-07-08T14:33:10.354Z","You","Errored, Not Charged","o3",0,0,0,0,0,"Included"
"2025-07-08T14:30:00.523Z","You","Included in Pro","o3",0,5064,50768,2026,57858,"Included"
"2025-07-08T14:26:10.364Z","You","Included in Pro","o3",0,7848,14568,1148,23564,"Included"
"2025-07-08T14:23:34.074Z","You","Included in Pro","gemini-2.5-pro-preview-05-06",0,5373,21494,1547,28414,"Included"
"2025-07-08T14:21:46.530Z","You","Included in Pro","gemini-2.5-pro-preview-05-06",0,9009,38702,1048,48759,"Included"
"2025-07-08T14:20:18.202Z","You","Included in Pro","gemini-2.5-pro-preview-05-06",0,8754,35019,828,44601,"Included"
"2025-07-08T14:17:58.562Z","You","Included in Pro","gemini-2.5-pro-preview-05-06",0,6404,25620,1068,33092,"Included"
"2025-07-08T14:15:07.486Z","You","Included in Pro","gemini-2.5-pro-preview-05-06",0,5190,20760,3689,29639,"Included"
"2025-07-08T14:10:50.069Z","You","Included in Pro","gemini-2.5-pro-preview-05-06",0,12441,49771,877,63089,"Included"
"2025-07-08T14:05:47.296Z","You","Included in Pro","gemini-2.5-pro-preview-05-06",0,16950,67810,1784,86544,"Included"
"2025-07-08T14:00:17.089Z","You","Included in Pro","gemini-2.5-pro-preview-05-06",0,97402,436982,6825,541209,"Included"
"2025-07-08T13:55:25.989Z","You","Included in Pro","gemini-2.5-pro-preview-05-06",0,85645,397902,5659,489206,"Included"
"2025-07-08T13:51:49.573Z","You","Included in Pro","gemini-2.5-pro-preview-05-06",0,62011,248540,9318,319869,"Included"
"2025-07-08T13:48:34.432Z","You","Included in Pro","gemini-2.5-pro-preview-05-06",0,13039,56542,1041,70622,"Included"
"2025-07-08T13:47:15.239Z","You","Included in Pro","gemini-2.5-pro-preview-05-06",0,6833,27339,491,34663,"Included"
"2025-07-08T13:44:19.245Z","You","Included in Pro","gemini-2.5-pro-preview-05-06",0,48439,193762,922,243123,"Included"
"2025-07-08T13:31:52.656Z","You","Included in Pro","gemini-2.5-pro-preview-05-06",0,57406,320781,1395,379582,"Included"
"2025-07-08T13:29:07.128Z","You","Included in Pro","gemini-2.5-pro-preview-05-06",0,47725,240218,3126,291069,"Included"
"2025-07-08T13:24:45.662Z","You","Included in Pro","gemini-2.5-pro-preview-05-06",0,54308,233015,3753,291076,"Included"
"2025-07-08T13:24:09.525Z","You","Included in Pro","gemini-2.5-pro-preview-05-06",0,11578,46315,312,58205,"Included"
"2025-07-08T13:20:07.056Z","You","Included in Pro","gemini-2.5-pro-preview-05-06",0,79693,448063,1423,529179,"Included"
"2025-07-08T13:19:16.530Z","You","Included in Pro","gemini-2.5-pro-preview-05-06",0,18326,77892,152,96370,"Included"
"2025-07-08T13:18:13.934Z","You","Included in Pro","gemini-2.5-pro-preview-05-06",0,23549,116244,882,140675,"Included"
"2025-07-08T13:15:07.089Z","You","Included in Pro","gemini-2.5-pro-preview-05-06",0,8569,34278,601,43448,"Included"
"2025-07-08T13:11:54.990Z","You","Included in Pro","gemini-2.5-pro-preview-05-06",0,56182,251331,3352,310865,"Included"
"2025-07-08T13:08:11.724Z","You","Included in Pro","gemini-2.5-pro-preview-05-06",0,15159,96311,493,111963,"Included"
"2025-07-08T13:03:40.075Z","You","Included in Pro","gemini-2.5-pro-preview-05-06",0,42667,170703,6520,219890,"Included"
"2025-07-08T12:57:19.514Z","You","Included in Pro","gemini-2.5-pro-preview-05-06",0,230,920,178,1328,"Included"
"2025-07-08T12:51:55.994Z","You","Included in Pro","gemini-2.5-pro-preview-05-06",0,6118,24477,1261,31856,"Included"
"2025-07-08T12:46:42.205Z","You","Included in Pro","gemini-2.5-pro-preview-05-06",0,15169,60683,264,76116,"Included"
"2025-07-08T12:40:43.462Z","You","Included in Pro","gemini-2.5-pro-preview-05-06",0,30848,123418,8694,162960,"Included"
"2025-07-08T12:32:45.944Z","You","Included in Pro","gemini-2.5-pro-preview-05-06",0,43870,202571,8678,255119,"Included"
"2025-07-08T12:28:31.884Z","You","Included in Pro","gemini-2.5-pro-preview-05-06",0,3662,14649,204,18515,"Included"
"2025-07-08T11:30:32.214Z","You","Included in Pro","gemini-2.5-pro-preview-05-06",0,140532,643265,4546,788343,"Included"
"2025-07-08T11:18:41.345Z","You","Included in Pro","gemini-2.5-pro-preview-05-06",0,161462,738338,11707,911507,"Included"
"2025-07-08T11:17:20.440Z","You","Included in Pro","gemini-2.5-pro-preview-05-06",0,6816,27268,2068,36152,"Included"
"2025-07-08T11:12:40.482Z","You","Included in Pro","gemini-2.5-pro-preview-05-06",0,5286,21150,2574,29010,"Included"
"2025-07-08T11:08:43.037Z","You","Included in Pro","gemini-2.5-pro-preview-05-06",0,4180,16724,2034,22938,"Included"
"2025-07-08T10:46:42.838Z","You","Included in Pro","o3",0,15652,53484,2105,71241,"Included"
"2025-07-08T10:40:43.594Z","You","Included in Pro","o3",0,47502,138372,2929,188803,"Included"
"2025-07-08T10:34:55.794Z","You","Included in Pro","o3",0,27995,152504,5097,185596,"Included"
"2025-07-08T10:33:05.855Z","You","Included in Pro","o3",0,17267,6452,2628,26347,"Included"
"2025-07-08T10:28:04.107Z","You","Included in Pro","o3",0,43301,165640,9181,218122,"Included"
"2025-07-08T10:22:11.195Z","You","Included in Pro","claude-4-sonnet",29106,1498,200655,14270,245529,"Included"
"2025-07-08T10:18:33.178Z","You","Included in Pro","o3",0,9852,108836,3044,121732,"Included"
"2025-07-08T10:16:51.280Z","You","Included in Pro","gemini-2.5-pro-preview-05-06",0,6737,26955,616,34308,"Included"
"2025-07-08T10:15:00.795Z","You","Included in Pro","gemini-2.5-pro-preview-05-06",0,20735,86232,849,107816,"Included"
"2025-07-08T08:49:51.627Z","You","Included in Pro","auto",0,47245,38656,1351,87252,"Included"
"2025-07-08T07:48:58.754Z","You","Included in Pro","auto",0,18593,30464,603,49660,"Included"
"2025-07-08T07:44:37.604Z","You","Included in Pro","gemini-2.5-pro-preview-05-06",0,49393,213172,7965,270530,"Included"
"2025-07-08T07:42:26.660Z","You","Included in Pro","gemini-2.5-pro-preview-05-06",0,11987,47959,745,60691,"Included"
"2025-07-08T07:38:05.771Z","You","Included in Pro","gemini-2.5-pro-preview-05-06",0,30244,121004,4498,155746,"Included"
"2025-07-08T06:20:25.086Z","You","Included in Pro","gemini-2.5-pro-preview-05-06",0,67001,367571,1966,436538,"Included"
"2025-07-08T06:17:42.168Z","You","Included in Pro","auto",0,0,0,0,0,"Included"
"2025-07-08T05:34:58.541Z","You","Included in Pro","gemini-2.5-pro-preview-05-06",0,28652,383839,801,413292,"Included"
"2025-07-08T05:31:04.659Z","You","Included in Pro","gemini-2.5-pro-preview-05-06",0,324,1300,64,1688,"Included"
"2025-07-08T05:28:51.528Z","You","Included in Pro","gemini-2.5-pro-preview-05-06",0,43990,362866,673,407529,"Included"
"2025-07-08T05:23:44.370Z","You","Included in Pro","gemini-2.5-pro-preview-05-06",0,35069,264324,607,300000,"Included"
"2025-07-08T05:20:06.152Z","You","Included in Pro","gemini-2.5-pro-preview-05-06",0,117267,1073399,4950,1195616,"Included"
"2025-07-08T05:12:16.930Z","You","Included in Pro","gemini-2.5-pro-preview-05-06",0,47398,230357,1302,279057,"Included"
"2025-07-07T15:34:58.237Z","You","Included in Pro","o3",0,13383,41424,1771,56578,"Included"
"2025-07-07T15:34:36.440Z","You","Errored, Not Charged","o3",0,0,0,0,0,"Included"
"2025-07-07T15:33:05.853Z","You","Included in Pro","o3",0,1580,8244,903,10727,"Included"
"2025-07-07T15:30:00.384Z","You","Included in Pro","o3",0,7713,42116,2454,52283,"Included"
"2025-07-07T15:29:10.852Z","You","Included in Pro","auto",0,2020,15104,955,18079,"Included"
"2025-07-07T15:28:16.672Z","You","Included in Pro","auto",0,13355,24832,444,38631,"Included"
"2025-07-07T15:28:04.076Z","You","Included in Pro","auto",0,8071,9984,584,18639,"Included"
"2025-07-07T15:27:22.610Z","You","Included in Pro","auto",0,6057,22144,354,28555,"Included"
"2025-07-07T15:27:08.171Z","You","Included in Pro","auto",0,2020,5888,257,8165,"Included"
"2025-07-07T15:25:00.276Z","You","Included in Pro","gemini-2.5-pro-preview-05-06",0,3110,12447,355,15912,"Included"
"2025-07-07T15:22:44.890Z","You","Included in Pro","gemini-2.5-pro-preview-05-06",0,2686,10747,618,14051,"Included"
"2025-07-07T15:17:37.931Z","You","Included in Pro","gemini-2.5-pro-preview-05-06",0,2968,11877,496,15341,"Included"
"2025-07-07T15:15:04.018Z","You","Included in Pro","gemini-2.5-pro-preview-05-06",0,3946,15786,1034,20766,"Included"
"2025-07-07T15:13:09.960Z","You","Included in Pro","gemini-2.5-pro-preview-05-06",0,4314,38750,1092,44156,"Included"
"2025-07-07T15:11:20.343Z","You","Included in Pro","gemini-2.5-pro-preview-05-06",0,2323,9295,491,12109,"Included"
"2025-07-07T15:05:27.901Z","You","Included in Pro","gemini-2.5-pro-preview-05-06",0,30179,224503,3111,257793,"Included"
"2025-07-07T15:01:14.610Z","You","Included in Pro","gemini-2.5-pro-preview-05-06",0,3777,38726,1240,43743,"Included"
"2025-07-07T15:00:32.283Z","You","Errored, Not Charged","gemini-2.5-pro-preview-05-06",0,0,0,0,0,"Included"
"2025-07-07T14:57:56.244Z","You","Included in Pro","gemini-2.5-pro-preview-05-06",0,4724,18899,712,24335,"Included"
"2025-07-07T14:43:23.048Z","You","Included in Pro","gemini-2.5-pro-preview-05-06",0,5221,33306,1135,39662,"Included"
"2025-07-07T14:43:07.695Z","You","Errored, Not Charged","gemini-2.5-pro-preview-05-06",0,0,0,0,0,"Included"
"2025-07-07T14:41:43.431Z","You","Included in Pro","gemini-2.5-pro-preview-05-06",0,4318,17643,1180,23141,"Included"
"2025-07-07T14:35:53.434Z","You","Included in Pro","gemini-2.5-pro-preview-05-06",0,1967,15137,911,18015,"Included"
"2025-07-07T14:35:34.343Z","You","Errored, Not Charged","gemini-2.5-pro-preview-05-06",0,0,0,0,0,"Included"
"2025-07-07T14:32:39.823Z","You","Included in Pro","gemini-2.5-pro-preview-05-06",0,5176,23396,2291,30863,"Included"
"2025-07-07T14:30:52.313Z","You","Included in Pro","gemini-2.5-pro-preview-05-06",0,4229,16919,1334,22482,"Included"
"2025-07-07T13:48:14.448Z","You","Included in Pro","auto",0,6793,50944,331,58068,"Included"
"2025-07-07T13:45:58.652Z","You","Included in Pro","auto",0,37723,64640,1734,104097,"Included"
"2025-07-07T13:43:39.916Z","You","Included in Pro","gemini-2.5-pro-preview-05-06",0,6078,35546,479,42103,"Included"
"2025-07-07T13:42:16.460Z","You","Included in Pro","gemini-2.5-pro-preview-05-06",0,3039,12160,458,15657,"Included"
"2025-07-07T13:33:20.403Z","You","Included in Pro","gemini-2.5-pro-preview-05-06",0,30776,354745,9168,394689,"Included"
"2025-07-07T13:32:46.198Z","You","Included in Pro","gemini-2.5-pro-preview-05-06",0,6947,27792,252,34991,"Included"
"2025-07-07T13:31:38.410Z","You","Included in Pro","gemini-2.5-pro-preview-05-06",0,6892,27572,148,34612,"Included"
"2025-07-07T13:25:28.937Z","You","Included in Pro","gemini-2.5-pro-preview-05-06",0,55807,449630,7348,512785,"Included"
"2025-07-07T13:21:21.766Z","You","Included in Pro","gemini-2.5-pro-preview-05-06",0,43060,447008,2362,492430,"Included"
"2025-07-07T13:09:11.691Z","You","Included in Pro","gemini-2.5-pro-preview-05-06",0,84499,811177,13977,909653,"Included"
"2025-07-07T13:04:21.046Z","You","Included in Pro","gemini-2.5-pro-preview-05-06",0,11623,78422,2702,92747,"Included"
"2025-07-07T13:00:40.733Z","You","Included in Pro","gemini-2.5-pro-preview-05-06",0,38722,246141,1267,286130,"Included"
"2025-07-07T12:52:33.630Z","You","Included in Pro","gemini-2.5-pro-preview-05-06",0,74327,588409,5220,667956,"Included"
"2025-07-07T12:49:38.022Z","You","Included in Pro","gemini-2.5-pro-preview-05-06",0,10380,69507,438,80325,"Included"
"2025-07-07T12:42:09.260Z","You","Included in Pro","gemini-2.5-pro-preview-05-06",0,72454,608881,15220,696555,"Included"
"2025-07-07T12:39:02.085Z","You","Included in Pro","gemini-2.5-pro-preview-05-06",0,21736,215043,1023,237802,"Included"
"2025-07-07T12:37:48.720Z","You","Included in Pro","gemini-2.5-pro-preview-05-06",0,12961,84465,992,98418,"Included"
"2025-07-07T12:34:08.154Z","You","Included in Pro","gemini-2.5-pro-preview-05-06",0,27675,143206,8338,179219,"Included"
"2025-07-07T12:29:29.484Z","You","Included in Pro","gemini-2.5-pro-preview-05-06",0,3014,12057,1148,16219,"Included"
"2025-07-07T12:22:50.382Z","You","Included in Pro","gemini-2.5-pro-preview-05-06",0,947,3792,88,4827,"Included"
"2025-07-07T12:22:45.311Z","You","Included in Pro","gemini-2.5-pro-preview-05-06",0,47869,339877,6287,394033,"Included"
"2025-07-07T12:14:39.665Z","You","Included in Pro","gemini-2.5-pro-preview-05-06",0,19164,76669,7100,102933,"Included"
"2025-07-07T12:01:15.256Z","You","Included in Pro","gemini-2.5-pro-preview-05-06",0,73836,447919,6841,528596,"Included"
"2025-07-07T11:06:27.620Z","You","Included in Pro","o3",0,31423,624156,9361,664940,"Included"
"2025-07-07T11:06:16.464Z","You","Errored, Not Charged","auto",0,0,0,0,0,"Included"
"2025-07-07T11:05:03.603Z","You","Included in Pro","auto",0,7161,47744,263,55168,"Included"
"2025-07-07T11:04:29.949Z","You","Included in Pro","auto",0,0,0,0,0,"Included"
"2025-07-07T10:59:53.874Z","You","Included in Pro","gemini-2.5-pro-preview-05-06",0,19088,165402,589,185079,"Included"
"2025-07-07T10:55:12.236Z","You","Included in Pro","gemini-2.5-pro-preview-05-06",0,44561,353160,4507,402228,"Included"
"2025-07-07T10:52:23.372Z","You","Included in Pro","gemini-2.5-pro-preview-05-06",0,19892,294414,550,314856,"Included"
"2025-07-07T10:50:40.733Z","You","Included in Pro","gemini-2.5-pro-preview-05-06",0,14751,103609,252,118612,"Included"
"2025-07-07T10:46:01.843Z","You","Included in Pro","gemini-2.5-pro-preview-05-06",0,79236,654309,4251,737796,"Included"
"2025-07-07T10:27:14.962Z","You","Included in Pro","gemini-2.5-pro-preview-05-06",0,195588,1713441,16937,1925966,"Included"
"2025-07-07T09:51:28.873Z","You","Included in Pro","gemini-2.5-pro-preview-05-06",0,53505,359018,4605,417128,"Included"
"2025-07-07T09:49:55.883Z","You","Included in Pro","gemini-2.5-pro-preview-05-06",0,8230,42905,2396,53531,"Included"
"2025-07-07T09:37:59.819Z","You","Included in Pro","gemini-2.5-pro-preview-05-06",0,88083,634089,20410,742582,"Included"
"2025-07-07T09:30:55.826Z","You","Included in Pro","gemini-2.5-pro-preview-05-06",0,3759,15043,2370,21172,"Included"
"2025-07-07T09:20:24.478Z","You","Included in Pro","gemini-2.5-pro-preview-05-06",0,10795,43184,1188,55167,"Included"
"2025-07-07T09:08:13.693Z","You","Included in Pro","gemini-2.5-pro-preview-05-06",0,13652,92208,822,106682,"Included"
"2025-07-07T08:47:38.323Z","You","Included in Pro","gemini-2.5-pro-preview-05-06",0,38381,243883,2491,284755,"Included"
"2025-07-07T08:47:13.723Z","You","Errored, Not Charged","gemini-2.5-pro-preview-05-06",0,0,0,0,0,"Included"
"2025-07-07T08:17:44.636Z","You","Included in Pro","gemini-2.5-pro-preview-05-06",0,16570,81560,1882,100012,"Included"
"2025-07-07T08:10:35.313Z","You","Included in Pro","gemini-2.5-pro-preview-05-06",0,4093,16375,4195,24663,"Included"
"2025-07-07T08:08:12.677Z","You","Included in Pro","gemini-2.5-pro-preview-05-06",0,28788,187540,5527,221855,"Included"
"2025-07-07T08:02:00.313Z","You","Included in Pro","gemini-2.5-pro-preview-05-06",0,4935,19741,906,25582,"Included"
"2025-07-07T07:57:52.648Z","You","Included in Pro","gemini-2.5-pro-preview-05-06",0,972,3889,151,5012,"Included"
"2025-07-07T07:54:34.532Z","You","Included in Pro","gemini-2.5-pro-preview-05-06",0,7995,39127,4275,51397,"Included"
"2025-07-07T05:53:39.114Z","You","Errored, Not Charged","gemini-2.5-pro-preview-05-06",0,65462,388756,14672,468890,"Included"
"2025-07-07T05:51:38.999Z","You","Errored, Not Charged","gemini-2.5-pro-preview-05-06",0,0,0,0,0,"Included"
"2025-07-07T05:41:44.931Z","You","Included in Pro","gemini-2.5-pro-preview-05-06",0,67060,453837,13351,534248,"Included"
"2025-07-07T05:05:13.275Z","You","Included in Pro","gemini-2.5-pro-preview-05-06",0,131690,1497753,15062,1644505,"Included"
"2025-07-07T04:57:53.731Z","You","Included in Pro","gemini-2.5-pro-preview-05-06",0,43807,279300,11174,334281,"Included"
"2025-07-07T04:51:24.572Z","You","Included in Pro","gemini-2.5-pro-preview-05-06",0,2271,9086,831,12188,"Included"
"2025-07-07T04:49:27.228Z","You","Included in Pro","gemini-2.5-pro-preview-05-06",0,1349,5399,548,7296,"Included"
"2025-07-07T04:44:45.230Z","You","Included in Pro","gemini-2.5-pro-preview-05-06",0,3034,12142,603,15779,"Included"
"2025-07-06T10:30:48.172Z","You","Included in Pro","gemini-2.5-pro-preview-05-06",0,1475,5905,185,7565,"Included"
"2025-07-06T10:29:16.165Z","You","Included in Pro","gemini-2.5-pro-preview-05-06",0,3823,15903,392,20118,"Included"
"2025-07-06T10:24:45.533Z","You","Included in Pro","gemini-2.5-pro-preview-05-06",0,4642,18571,1338,24551,"Included"
"2025-07-06T10:16:37.692Z","You","Included in Pro","gemini-2.5-pro-preview-05-06",0,2696,10786,1274,14756,"Included"
"2025-07-06T10:09:20.569Z","You","Included in Pro","gemini-2.5-pro-preview-05-06",0,3050,12202,2483,17735,"Included"
"2025-07-06T10:07:55.849Z","You","Included in Pro","gemini-2.5-pro-preview-05-06",0,2009,8043,2247,12299,"Included"
"2025-07-06T10:04:08.938Z","You","Included in Pro","gemini-2.5-pro-preview-05-06",0,2500,10001,1131,13632,"Included"
"2025-07-06T09:56:35.182Z","You","Included in Pro","gemini-2.5-pro-preview-05-06",0,2140,8560,1460,12160,"Included"
"2025-07-06T09:53:47.545Z","You","Included in Pro","gemini-2.5-pro-preview-05-06",0,6376,25504,617,32497,"Included"
"2025-07-06T09:38:23.244Z","You","Included in Pro","gemini-2.5-pro-preview-05-06",0,3710,15635,557,19902,"Included"
"2025-07-06T09:35:54.142Z","You","Included in Pro","gemini-2.5-pro-preview-05-06",0,1906,7629,469,10004,"Included"
"2025-07-06T09:32:31.904Z","You","Included in Pro","gemini-2.5-pro-preview-05-06",0,1155,4621,214,5990,"Included"
"2025-07-06T09:31:33.597Z","You","Included in Pro","gemini-2.5-pro-preview-05-06",0,2876,11509,877,15262,"Included"
"2025-07-06T08:45:20.194Z","You","Included in Pro","gemini-2.5-pro-preview-05-06",0,15980,129228,2746,147954,"Included"
"2025-07-06T08:38:45.935Z","You","Included in Pro","gemini-2.5-pro-preview-05-06",0,27977,141625,1849,171451,"Included"
"2025-07-06T08:36:01.433Z","You","Included in Pro","gemini-2.5-pro-preview-05-06",0,12739,77105,1945,91789,"Included"
"2025-07-06T08:16:09.203Z","You","Included in Pro","gemini-2.5-pro-preview-05-06",0,5864,23463,1747,31074,"Included"
"2025-07-06T08:12:06.604Z","You","Included in Pro","gemini-2.5-pro-preview-05-06",0,3732,14934,2060,20726,"Included"
"2025-07-06T08:05:09.098Z","You","Included in Pro","gemini-2.5-pro-preview-05-06",0,10979,52560,5264,68803,"Included"
"2025-07-06T07:58:29.142Z","You","Included in Pro","gemini-2.5-pro-preview-05-06",0,11061,61590,764,73415,"Included"
"2025-07-06T07:14:45.851Z","You","Included in Pro","gemini-2.5-pro-preview-05-06",0,6933,62536,595,70064,"Included"
"2025-07-06T07:05:06.150Z","You","Included in Pro","gemini-2.5-pro-preview-05-06",0,6330,58226,1702,66258,"Included"
"2025-07-06T07:00:27.897Z","You","Included in Pro","gemini-2.5-pro-preview-05-06",0,12225,48906,411,61542,"Included"
"2025-07-05T18:15:39.164Z","You","Included in Pro","gemini-2.5-pro-preview-05-06",0,7947,49745,694,58386,"Included"
"2025-07-05T18:14:45.793Z","You","Included in Pro","gemini-2.5-pro-preview-05-06",0,0,0,0,0,"Included"
"2025-07-05T18:13:38.659Z","You","Included in Pro","gemini-2.5-pro-preview-05-06",0,5150,49680,915,55745,"Included"
"2025-07-05T18:13:23.986Z","You","Errored, Not Charged","gemini-2.5-pro-preview-05-06",0,0,0,0,0,"Included"
"2025-07-05T18:09:24.839Z","You","Included in Pro","gemini-2.5-pro-preview-05-06",0,4696,18789,368,23853,"Included"
"2025-07-05T18:06:12.779Z","You","Included in Pro","gemini-2.5-pro-preview-05-06",0,2671,10690,391,13752,"Included"
"2025-07-05T18:03:40.228Z","You","Included in Pro","gemini-2.5-pro-preview-05-06",0,3175,12704,625,16504,"Included"
"2025-07-05T18:01:37.553Z","You","Included in Pro","gemini-2.5-pro-preview-05-06",0,2237,8950,1062,12249,"Included"
"2025-07-05T18:00:52.287Z","You","Included in Pro","gemini-2.5-pro-preview-05-06",0,5708,22839,650,29197,"Included"
"2025-07-05T17:57:22.008Z","You","Included in Pro","gemini-2.5-pro-preview-05-06",0,3976,15908,1631,21515,"Included"
"2025-07-05T13:13:31.226Z","You","Included in Pro","gemini-2.5-pro-preview-05-06",0,17439,92783,3042,113264,"Included"
"2025-07-05T13:10:00.841Z","You","Included in Pro","gemini-2.5-pro-preview-05-06",0,7810,31694,2078,41582,"Included"
"2025-07-05T13:04:20.219Z","You","Included in Pro","gemini-2.5-pro-preview-05-06",0,3270,13086,578,16934,"Included"
"2025-07-05T11:21:12.041Z","You","Included in Pro","gemini-2.5-pro-preview-05-06",0,100607,1079343,6978,1186928,"Included"
"2025-07-05T10:59:43.237Z","You","Included in Pro","gemini-2.5-pro-preview-05-06",0,15360,185976,2758,204094,"Included"
"2025-07-05T10:55:01.230Z","You","Included in Pro","gemini-2.5-pro-preview-05-06",0,27864,269036,2331,299231,"Included"
"2025-07-05T10:48:14.495Z","You","Included in Pro","gemini-2.5-pro-preview-05-06",0,10580,63943,600,75123,"Included"
"2025-07-05T10:42:38.271Z","You","Included in Pro","gemini-2.5-pro-preview-05-06",0,10167,42551,7426,60144,"Included"
"2025-07-05T10:42:34.239Z","You","Aborted, Not Charged","gemini-2.5-pro-preview-05-06",0,0,0,0,0,"Included"
"2025-07-05T10:37:20.928Z","You","Included in Pro","gemini-2.5-pro-preview-05-06",0,1088,4354,190,5632,"Included"
"2025-07-05T09:46:06.078Z","You","Included in Pro","gemini-2.5-pro-preview-05-06",0,301570,2000708,8352,2310630,"Included"
"2025-07-05T09:16:54.020Z","You","Included in Pro","gemini-2.5-pro-preview-05-06",0,109887,937962,33986,1081835,"Included"
"2025-07-05T09:13:17.788Z","You","Included in Pro","gemini-2.5-pro-preview-05-06",0,24108,123723,2463,150294,"Included"
"2025-07-05T09:09:10.770Z","You","Included in Pro","gemini-2.5-pro-preview-05-06",0,2614,10458,2485,15557,"Included"
"2025-07-05T07:43:03.997Z","You","Included in Pro","gemini-2.5-pro-preview-05-06",0,131261,1932418,17615,2081294,"Included"
"2025-07-05T07:40:01.492Z","You","Included in Pro","gemini-2.5-pro-preview-05-06",0,29728,217301,2500,249529,"Included"
"2025-07-05T07:38:02.861Z","You","Included in Pro","gemini-2.5-pro-preview-05-06",0,9431,55012,1081,65524,"Included"
"2025-07-05T07:35:56.529Z","You","Included in Pro","gemini-2.5-pro-preview-05-06",0,8137,35502,1519,45158,"Included"
"2025-07-05T07:34:28.188Z","You","Included in Pro","gemini-2.5-pro-preview-05-06",0,21010,97356,1202,119568,"Included"
"2025-07-05T07:30:05.175Z","You","Included in Pro","gemini-2.5-pro-preview-05-06",0,14348,73701,1628,89677,"Included"
"2025-07-05T07:29:37.154Z","You","Errored, Not Charged","gemini-2.5-pro-preview-05-06",0,0,0,0,0,"Included"
"2025-07-05T07:09:59.911Z","You","Included in Pro","gemini-2.5-pro-preview-05-06",0,445766,8781938,35930,9263634,"Included"
"2025-07-05T06:59:18.498Z","You","Included in Pro","gemini-2.5-pro-preview-05-06",0,144702,1320790,23932,1489424,"Included"
"2025-07-05T06:49:02.270Z","You","Included in Pro","gemini-2.5-pro-preview-05-06",0,126046,1290862,11917,1428825,"Included"
"2025-07-05T06:40:55.034Z","You","Included in Pro","gemini-2.5-pro-preview-05-06",0,15139,70489,6214,91842,"Included"
"2025-07-05T06:39:49.882Z","You","Included in Pro","gemini-2.5-pro-preview-05-06",0,963,3855,931,5749,"Included"
"2025-07-05T06:39:24.559Z","You","Errored, Not Charged","gemini-2.5-pro-preview-05-06",0,0,0,0,0,"Included"
"2025-07-05T06:36:44.425Z","You","Included in Pro","gemini-2.5-pro-preview-05-06",0,8691,35032,810,44533,"Included"
"2025-07-05T06:32:51.679Z","You","Included in Pro","gemini-2.5-pro-preview-05-06",0,1298,5192,748,7238,"Included"
"2025-07-05T06:20:31.858Z","You","Included in Pro","gemini-2.5-pro-preview-05-06",0,21216,113336,3737,138289,"Included"
"2025-07-05T06:11:28.681Z","You","Included in Pro","gemini-2.5-pro-preview-05-06",0,20430,83152,3854,107436,"Included"
"2025-07-05T06:03:47.798Z","You","Included in Pro","gemini-2.5-pro-preview-05-06",0,112612,1030986,19212,1162810,"Included"
"2025-07-05T05:59:11.340Z","You","Included in Pro","gemini-2.5-pro-preview-05-06",0,5970,32714,2933,41617,"Included"
"2025-07-05T05:55:12.683Z","You","Included in Pro","gemini-2.5-pro-preview-05-06",0,3527,14949,1535,20011,"Included"
"2025-07-05T05:53:12.479Z","You","Included in Pro","gemini-2.5-pro-preview-05-06",0,1702,6810,1152,9664,"Included"
"2025-07-05T05:49:55.626Z","You","Included in Pro","gemini-2.5-pro-preview-05-06",0,2639,10561,1854,15054,"Included"
"2025-07-05T05:19:12.644Z","You","Included in Pro","gemini-2.5-pro-preview-05-06",0,32780,233786,3294,269860,"Included"
"2025-07-05T05:12:31.848Z","You","Included in Pro","gemini-2.5-pro-preview-05-06",0,84926,708645,11158,804729,"Included"
"2025-07-05T05:11:08.011Z","You","Included in Pro","gemini-2.5-pro-preview-05-06",0,6537,26152,1388,34077,"Included"
"2025-07-05T05:09:49.605Z","You","Included in Pro","gemini-2.5-pro-preview-05-06",0,7937,31751,315,40003,"Included"
"2025-07-05T04:41:37.920Z","You","Included in Pro","gemini-2.5-pro-preview-05-06",0,15689,76186,2123,93998,"Included"
"2025-07-05T04:30:45.162Z","You","Included in Pro","gemini-2.5-pro-preview-05-06",0,91007,707130,13910,812047,"Included"
"2025-07-05T04:26:06.157Z","You","Included in Pro","gemini-2.5-pro-preview-05-06",0,22415,162279,7026,191720,"Included"
"2025-07-05T04:23:46.566Z","You","Included in Pro","gemini-2.5-pro-preview-05-06",0,9021,38907,1295,49223,"Included"
"2025-07-04T15:04:42.448Z","You","Included in Pro","gemini-2.5-pro-preview-05-06",0,11037,54983,479,66499,"Included"
"2025-07-04T14:58:29.104Z","You","Included in Pro","gemini-2.5-pro-preview-05-06",0,34508,184238,2921,221667,"Included"
"2025-07-04T10:30:56.090Z","You","Included in Pro","gemini-2.5-pro-preview-05-06",0,23453,213944,1146,238543,"Included"
"2025-07-04T09:41:06.611Z","You","Included in Pro","gemini-2.5-pro-preview-05-06",0,77046,336377,6224,419647,"Included"
"2025-07-04T09:39:51.563Z","You","Included in Pro","gemini-2.5-pro-preview-05-06",0,11395,45580,1578,58553,"Included"
"2025-07-04T08:45:25.113Z","You","Included in Pro","gemini-2.5-pro-preview-05-06",0,2601,52520,1766,56887,"Included"
"2025-07-04T08:41:16.111Z","You","Included in Pro","gemini-2.5-pro-preview-05-06",0,17201,92597,466,110264,"Included"
"2025-07-04T08:39:11.756Z","You","Included in Pro","gemini-2.5-pro-preview-05-06",0,16581,86950,2788,106319,"Included"
"2025-07-04T08:16:37.014Z","You","Included in Pro","gemini-2.5-pro-preview-05-06",0,39579,221472,6211,267262,"Included"
"2025-07-04T07:56:59.331Z","You","Included in Pro","gemini-2.5-pro-preview-05-06",0,30607,227786,7340,265733,"Included"
"2025-07-04T07:54:50.002Z","You","Included in Pro","gemini-2.5-pro-preview-05-06",0,2913,11652,2476,17041,"Included"
"2025-07-04T07:22:40.116Z","You","Included in Pro","gemini-2.5-pro-preview-05-06",0,5372,21493,1642,28507,"Included"
"2025-07-04T06:32:23.876Z","You","Included in Pro","gemini-2.5-pro-preview-05-06",0,15095,199760,2612,217467,"Included"
"2025-07-04T06:26:46.147Z","You","Included in Pro","gemini-2.5-pro-preview-05-06",0,3241,63765,1387,68393,"Included"
"2025-07-04T06:25:18.761Z","You","Included in Pro","gemini-2.5-pro-preview-05-06",0,2286,63807,820,66913,"Included"
"2025-07-04T06:23:32.986Z","You","Included in Pro","gemini-2.5-pro-preview-05-06",0,8311,123379,485,132175,"Included"
"2025-07-04T06:21:22.478Z","You","Included in Pro","gemini-2.5-pro-preview-05-06",0,12147,119121,1335,132603,"Included"
"2025-07-04T06:20:19.697Z","You","Included in Pro","gemini-2.5-pro-preview-05-06",0,14372,110578,188,125138,"Included"
"2025-07-04T06:19:30.190Z","You","Included in Pro","gemini-2.5-pro-preview-05-06",0,11372,110574,1419,123365,"Included"
"2025-07-04T06:18:32.885Z","You","Included in Pro","gemini-2.5-pro-preview-05-06",0,6930,110566,1153,118649,"Included"
"2025-07-04T06:16:57.796Z","You","Included in Pro","gemini-2.5-pro-preview-05-06",0,16964,97464,291,114719,"Included"
"2025-07-04T06:15:44.826Z","You","Included in Pro","gemini-2.5-pro-preview-05-06",0,9037,102009,925,111971,"Included"
"2025-07-04T06:14:57.422Z","You","Included in Pro","gemini-2.5-pro-preview-05-06",0,17774,89256,1214,108244,"Included"
"2025-07-04T06:13:51.499Z","You","Included in Pro","gemini-2.5-pro-preview-05-06",0,13301,89254,1035,103590,"Included"
"2025-07-04T06:12:27.871Z","You","Included in Pro","gemini-2.5-pro-preview-05-06",0,24495,113320,3311,141126,"Included"
"2025-07-04T05:59:28.801Z","You","Included in Pro","gemini-2.5-pro-preview-05-06",0,8191,45824,1677,55692,"Included"
"2025-07-04T05:53:17.789Z","You","Included in Pro","gemini-2.5-pro-preview-05-06",0,8559,34244,2730,45533,"Included"
"2025-07-04T05:33:23.354Z","You","Included in Pro","gemini-2.5-pro-preview-05-06",0,6933,27738,3678,38349,"Included"
"2025-07-04T05:20:27.229Z","You","Included in Pro","gemini-2.5-pro-preview-05-06",0,5340,21362,1300,28002,"Included"
"2025-07-04T05:17:44.953Z","You","Included in Pro","gemini-2.5-pro-preview-05-06",0,4344,17382,2284,24010,"Included"
"2025-07-04T05:08:18.761Z","You","Included in Pro","gemini-2.5-pro-preview-05-06",0,21222,131376,1243,153841,"Included"
"2025-07-04T05:00:21.451Z","You","Included in Pro","gemini-2.5-pro-preview-05-06",0,78916,634438,12038,725392,"Included"
"2025-07-04T04:58:42.732Z","You","Included in Pro","gemini-2.5-pro-preview-05-06",0,2185,8741,340,11266,"Included"
"2025-07-04T04:53:14.297Z","You","Included in Pro","o3",0,18420,101612,2732,122764,"Included"
"2025-07-04T04:52:03.138Z","You","Included in Pro","gemini-2.5-pro-preview-05-06",0,12711,86844,932,100487,"Included"
"2025-07-04T04:51:22.687Z","You","Included in Pro","gemini-2.5-pro-preview-05-06",0,12573,78417,769,91759,"Included"
"2025-07-04T04:50:47.281Z","You","Included in Pro","gemini-2.5-pro-preview-05-06",0,5509,78699,430,84638,"Included"
"2025-07-04T04:49:57.296Z","You","Included in Pro","gemini-2.5-pro-preview-05-06",0,14857,59433,392,74682,"Included"
"2025-07-04T04:48:55.810Z","You","Included in Pro","gemini-2.5-pro-preview-05-06",0,5165,20663,672,26500,"Included"
"2025-07-04T04:44:06.556Z","You","Included in Pro","gemini-2.5-pro-preview-05-06",0,17014,68066,15964,101044,"Included"
"2025-07-04T04:19:01.465Z","You","Included in Pro","gemini-2.5-pro-preview-05-06",0,278539,4172367,40816,4491722,"Included"
"2025-07-04T04:13:45.286Z","You","Included in Pro","gemini-2.5-pro-preview-05-06",0,51500,407594,8797,467891,"Included"
"2025-07-04T04:09:07.981Z","You","Included in Pro","gemini-2.5-pro-preview-05-06",0,71880,886622,5859,964361,"Included"
"2025-07-04T04:06:07.934Z","You","Included in Pro","gemini-2.5-pro-preview-05-06",0,60323,566606,5489,632418,"Included"
"2025-07-04T03:54:53.620Z","You","Included in Pro","gemini-2.5-pro-preview-05-06",0,108615,797279,12312,918206,"Included"
"2025-07-04T03:53:07.803Z","You","Included in Pro","gpt-4.1",0,113,58624,363,59100,"Included"
"2025-07-04T03:52:14.130Z","You","Included in Pro","gpt-4.1",0,217,57472,1022,58711,"Included"
"2025-07-04T03:49:49.429Z","You","Included in Pro","gpt-4.1",0,8744,140288,7318,156350,"Included"
"2025-07-04T03:47:15.593Z","You","Included in Pro","gpt-4.1",0,3597,72832,3537,79966,"Included"
"2025-07-04T03:43:39.087Z","You","Included in Pro","gpt-4.1",0,46825,50176,8909,105910,"Included"
"2025-07-04T03:43:07.003Z","You","Errored, Not Charged","gpt-4.1",0,0,0,0,0,"Included"
"2025-07-04T03:40:24.442Z","You","Included in Pro","o4-mini",0,13015,33000,10073,56088,"Included"
"2025-07-04T03:37:56.786Z","You","Included in Pro","o4-mini",0,11061,21095,10302,42458,"Included"
"2025-07-04T03:34:19.147Z","You","Included in Pro","o3",0,23405,203656,7693,234754,"Included"
"2025-07-04T03:29:02.891Z","You","Included in Pro","o3",0,23021,348456,7261,378738,"Included"
"2025-07-04T03:28:52.660Z","You","Errored, Not Charged","auto",0,0,0,0,0,"Included"
"2025-07-04T03:23:11.993Z","You","Errored, Not Charged","claude-4-sonnet-thinking",0,0,0,0,0,"Included"
"2025-07-04T03:03:40.018Z","You","Included in Pro","claude-4-sonnet-thinking",54386,469,717458,20802,793115,"Included"
"2025-07-04T02:46:54.734Z","You","Included in Pro","claude-4-sonnet",59799,196,509466,29445,598906,"Included"
"2025-07-04T02:28:03.059Z","You","Included in Pro","claude-4-sonnet",25760,335,1184705,10111,1220911,"Included"
"2025-07-04T02:10:45.801Z","You","Included in Pro","claude-4-sonnet",1860,1086,29317,389,32652,"Included"
"2025-07-04T02:07:19.839Z","You","Included in Pro","claude-4-sonnet",6150,1284,16973,2590,26997,"Included"
